"abbreviation"	"name"	"compartment"
"NAD"	"NAD"	"c, m, p, r, n, e"
"ethanol"	"ethanol"	"c, p"
"H"	"H"	"c, m, p, r, n, e, l, g"
"NADH"	"NADH"	"c, m, p, r"
"acetaldehyde"	"acetaldehyde"	"c, m, p"
"ATP"	"ATP"	"c, m, n, e, l, r, p, g"
"CoA"	"CoA"	"c, m, p, r, n, g, l"
"acetate"	"acetate"	"c, m, p, r, e, g"
"AMP"	"AMP"	"c, m, e, l, g, r, p, n"
"PPi"	"PPi"	"c, m, e, n, r, p"
"acetyl-CoA"	"acetyl-CoA"	"c, m, p, n, r, g"
"acetyladenylate"	"acetyladenylate"	"c"
"pyruvate"	"pyruvate"	"m, p, c, e"
"CO2"	"CO2"	"m, r, c, p, e, g"
"L-lactate"	"L-lactate"	"p, c, m, e"
"H2O"	"H2O"	"c, m, r, p, e, l, n, g"
"NADP"	"NADP"	"c, m, r, p, n, e"
"NADPH"	"NADPH"	"c, m, r, p, n"
"fructose-6-phosphate"	"fructose-6-phosphate"	"c"
"ADP"	"ADP"	"c, m, e, n, l, r, g"
"fructose-1,6-bisphosphate"	"fructose-1,6-bisphosphate"	"c"
"UTP"	"UTP"	"c, e, m, n"
"UDP"	"UDP"	"c, g, r, e, n, m, l"
"DHAP"	"DHAP"	"c, m, e, p"
"erythrose-4-phosphate"	"erythrose-4-phosphate"	"c"
"sedoheptulose-1,7-bisphosphate"	"sedoheptulose-1,7-bisphosphate"	"c"
"PEP"	"PEP"	"c, m"
"methylglyoxal"	"methylglyoxal"	"c"
"2-phospho-D-glycerate"	"2-phospho-D-glycerate"	"c"
"3-phospho-D-glycerate"	"3-phospho-D-glycerate"	"c, m"
"1,3-bisphospho-D-glycerate"	"1,3-bisphospho-D-glycerate"	"c"
"Pi"	"Pi"	"c, r, e, m, l, g, p, n"
"2,3-bisphospho-D-glycerate"	"2,3-bisphospho-D-glycerate"	"c"
"GAP"	"GAP"	"c"
"glucose"	"glucose"	"c, r, e, l, g"
"glucose-6-phosphate"	"glucose-6-phosphate"	"c, r"
"glucose-1-phosphate"	"glucose-1-phosphate"	"c"
"lipoamide"	"lipoamide"	"m"
"S-acetyldihydrolipoamide"	"S-acetyldihydrolipoamide"	"m"
"dihydrolipoamide"	"dihydrolipoamide"	"m, c"
"beta-D-glucose"	"beta-D-glucose"	"c"
"beta-D-glucose-6-phosphate"	"beta-D-glucose-6-phosphate"	"c"
"H2O2"	"H2O2"	"p, c, e, m, n, r, l"
"carbamoyl-phosphate"	"carbamoyl-phosphate"	"r, c, m"
"NH3"	"NH3"	"r, c, e, m, p, n"
"O2"	"O2"	"c, p, e, m, n, r"
"maltose"	"maltose"	"e, c, l"
"UDP-glucose"	"UDP-glucose"	"c, r, g"
"UDP-glucuronate"	"UDP-glucuronate"	"c, r, g"
"trehalose"	"trehalose"	"e"
"glycogeninG8"	"glycogeninG8"	"c"
"glycogeninG11"	"glycogeninG11"	"c"
"glycogen"	"glycogen"	"c"
"glycogeninG4G7"	"glycogeninG4G7"	"c"
"glycogeninG4G4"	"glycogeninG4G4"	"c"
"glycogeninG7G1"	"glycogeninG7G1"	"c"
"glycogeninG7"	"glycogeninG7"	"c"
"glycogenin"	"glycogenin"	"c"
"maltodecaose"	"maltodecaose"	"c, e"
"fructose"	"fructose"	"c, e"
"maltononaose"	"maltononaose"	"c, e"
"maltoheptaose"	"maltoheptaose"	"c, e"
"maltohexaose"	"maltohexaose"	"c, e"
"maltopentaose"	"maltopentaose"	"c, e"
"maltotetraose"	"maltotetraose"	"c, e"
"maltotriose"	"maltotriose"	"c, e, l"
"starchstructure1"	"starchstructure1"	"c"
"starchstructure2"	"starchstructure2"	"c"
"glucose-1,6-bisphosphate"	"glucose-1,6-bisphosphate"	"c"
"UDP-galactose"	"UDP-galactose"	"c, g, r"
"galactose"	"galactose"	"c, e, l"
"alpha-D-galactose-1-phosphate"	"alpha-D-galactose-1-phosphate"	"c"
"galactose-1-phosphate"	"galactose-1-phosphate"	"c"
"sucrose"	"sucrose"	"e"
"lactose"	"lactose"	"e, g"
"galactosylglycerol"	"galactosylglycerol"	"e"
"glycerol"	"glycerol"	"e, c, m"
"CDP"	"CDP"	"c, m, e, n, r"
"tagatose-1,6-bisphosphate"	"tagatose-1,6-bisphosphate"	"c"
"CTP"	"CTP"	"c, m, e, n"
"D-tagatose-6-phosphate"	"D-tagatose-6-phosphate"	"c"
"ITP"	"ITP"	"c, e, n, m"
"IDP"	"IDP"	"c, e, n, m"
"3-keto-beta-D-galactose"	"3-keto-beta-D-galactose"	"e"
"3-ketolactose"	"3-ketolactose"	"e"
"D-tagatose"	"D-tagatose"	"c"
"glyceraldehyde"	"glyceraldehyde"	"c, m"
"fructose-2,6-bisphosphate"	"fructose-2,6-bisphosphate"	"c"
"fructose-1-phosphate"	"fructose-1-phosphate"	"c"
"D-glucitol"	"D-glucitol"	"c, e, l, g"
"sorbitol-3-phosphate"	"sorbitol-3-phosphate"	"c"
"fructose-3-phosphate"	"fructose-3-phosphate"	"c"
"mannose-1-phosphate"	"mannose-1-phosphate"	"c"
"D-mannose-1,6-bisphosphate"	"D-mannose-1,6-bisphosphate"	"c"
"mannose-6-phosphate"	"mannose-6-phosphate"	"c"
"GDP"	"GDP"	"c, m, e, n, g"
"GDP-mannose"	"GDP-mannose"	"c"
"GTP"	"GTP"	"c, m, e, n"
"GDP-4-dehydro-6-deoxy-D-mannose"	"GDP-4-dehydro-6-deoxy-D-mannose"	"c"
"GDP-L-fucose"	"GDP-L-fucose"	"c, g"
"L-fucose-1-phosphate"	"L-fucose-1-phosphate"	"c"
"6-deoxy-L-galactose"	"6-deoxy-L-galactose"	"c, e, l"
"mannose"	"mannose"	"c, r, g, l, e"
"L-xylulose"	"L-xylulose"	"c"
"xylitol"	"xylitol"	"c"
"D-xylulose-5-phosphate"	"D-xylulose-5-phosphate"	"c"
"D-xylulose"	"D-xylulose"	"c"
"D-ribulose"	"D-ribulose"	"c"
"ribulose-5-phosphate"	"ribulose-5-phosphate"	"c, r"
"D-glucuronate1-phosphate"	"D-glucuronate1-phosphate"	"c"
"UMP"	"UMP"	"c, r, e, l, m, n, g"
"glucuronate"	"glucuronate"	"c, l"
"GSH"	"GSH"	"c, m, e, r, p"
"(R)-S-lactoylglutathione"	"(R)-S-lactoylglutathione"	"c, m"
"D-lactate"	"D-lactate"	"c, m, e"
"ferricytochromeC"	"ferricytochromeC"	"m, c"
"ferrocytochromeC"	"ferrocytochromeC"	"m, c"
"malate"	"malate"	"m, c"
"OAA"	"OAA"	"m, c, p"
"acetone"	"acetone"	"c, e, m"
"hydroxyacetone"	"hydroxyacetone"	"c"
"D-lactaldehyde"	"D-lactaldehyde"	"c"
"lactaldehyde"	"lactaldehyde"	"c, m"
"propane-1,2-diol"	"propane-1,2-diol"	"c"
"propanoyl-CoA"	"propanoyl-CoA"	"c, m, p"
"propanoate"	"propanoate"	"c, m, p, e"
"FAD"	"FAD"	"m, c, r, p, e"
"FADH2"	"FADH2"	"m, c, r, p"
"acrylyl-CoA"	"acrylyl-CoA"	"m"
"malonyl-CoA"	"malonyl-CoA"	"c, m, p, r"
"3-oxopropanoate"	"3-oxopropanoate"	"m"
"propinoladenylate"	"propinoladenylate"	"c, m"
"hydracrylate"	"hydracrylate"	"m"
"3-hydroxypropionyl-CoA"	"3-hydroxypropionyl-CoA"	"m"
"3-oxopropionyl-CoA"	"3-oxopropionyl-CoA"	"m"
"AKG"	"AKG"	"c, m, p, e"
"2-hydroxyglutarate"	"2-hydroxyglutarate"	"c"
"acetoacetyl-CoA"	"acetoacetyl-CoA"	"c, p, m"
"acetoacetate"	"acetoacetate"	"c, m, e"
"butyryl-CoA"	"butyryl-CoA"	"m, c, p"
"crotonyl-CoA"	"crotonyl-CoA"	"m, p"
"(R)-3-hydroxybutanoate"	"(R)-3-hydroxybutanoate"	"m, e, c"
"HMG-CoA"	"HMG-CoA"	"p, m, c"
"2-hydroxybutyrate"	"2-hydroxybutyrate"	"c, e"
"2-oxobutyrate"	"2-oxobutyrate"	"c, m"
"(R)-3-hydroxybutanoyl-CoA"	"(R)-3-hydroxybutanoyl-CoA"	"m"
"ribose-5-phosphate"	"ribose-5-phosphate"	"c, r"
"PRPP"	"PRPP"	"c, e"
"ribose"	"ribose"	"c, r"
"ribose-1-phosphate"	"ribose-1-phosphate"	"c"
"2-deoxy-D-ribose-5-phosphate"	"2-deoxy-D-ribose-5-phosphate"	"c"
"6-phospho-D-gluconate"	"6-phospho-D-gluconate"	"r, c"
"D-gluconicacid"	"D-gluconicacid"	"c"
"sedoheptulose-7-phosphate"	"sedoheptulose-7-phosphate"	"c"
"sedoheptulose"	"sedoheptulose"	"c"
"sedoheptulose-1-phosphate"	"sedoheptulose-1-phosphate"	"c"
"glucono-1,5-lactone-6-phosphate"	"glucono-1,5-lactone-6-phosphate"	"r, c"
"2-deoxy-D-ribose-1-phosphate"	"2-deoxy-D-ribose-1-phosphate"	"c"
"ribitol"	"ribitol"	"c"
"deoxyribose"	"deoxyribose"	"c"
"cAMP"	"cAMP"	"c, g, e"
"adenosine"	"adenosine"	"c, e, m, l"
"GMP"	"GMP"	"c, e, m, l, n, g"
"cGMP"	"cGMP"	"c, n, g, e"
"FAICAR"	"FAICAR"	"c"
"IMP"	"IMP"	"c, e"
"xanthosine-5-phosphate"	"xanthosine-5-phosphate"	"c"
"aspartate"	"aspartate"	"c, m, l, e"
"adenylosuccinate"	"adenylosuccinate"	"c"
"glutamine"	"glutamine"	"c, m, l, e"
"glutamate"	"glutamate"	"c, m, e, l, r"
"adenine"	"adenine"	"c, e, l"
"5-phosphoribosylamine"	"5-phosphoribosylamine"	"c"
"fumarate"	"fumarate"	"c, m"
"inosine"	"inosine"	"c, e, m"
"guanosine"	"guanosine"	"c, e, l, m"
"dADP"	"dADP"	"c, m, n"
"dAMP"	"dAMP"	"c, l"
"dATP"	"dATP"	"c, m, n"
"glucosamine"	"glucosamine"	"c, e"
"glucosamine-6-phosphate"	"glucosamine-6-phosphate"	"c"
"guanine"	"guanine"	"c, e"
"xanthine"	"xanthine"	"c"
"hypoxanthine"	"hypoxanthine"	"c, e"
"deoxyguanosine"	"deoxyguanosine"	"c, m, l, e"
"dGMP"	"dGMP"	"c, m, l"
"thioredoxin"	"thioredoxin"	"c, m, n"
"oxidizedthioredoxin"	"oxidizedthioredoxin"	"c, m, n"
"dGTP"	"dGTP"	"c, m, n"
"dGDP"	"dGDP"	"c, m, n"
"dCTP"	"dCTP"	"c, n, m"
"dUTP"	"dUTP"	"c, m, n"
"dCDP"	"dCDP"	"c, n, m"
"dUDP"	"dUDP"	"c, m, n"
"deoxyadenosine"	"deoxyadenosine"	"c, e, l"
"xanthosine"	"xanthosine"	"c"
"deoxyinosine"	"deoxyinosine"	"c, e"
"glycine"	"glycine"	"c, m, p, e, l"
"GAR"	"GAR"	"c"
"5-phosphoribosylformylglycinamidine"	"5-phosphoribosylformylglycinamidine"	"c"
"AIR"	"AIR"	"c"
"5-phosphoribosyl-4-carboxy-5-aminoimidazole"	"5-phosphoribosyl-4-carboxy-5-aminoimidazole"	"c"
"N-formyl-GAR"	"N-formyl-GAR"	"c"
"SAICAR"	"SAICAR"	"c"
"AICAR"	"AICAR"	"c"
"10-formyl-THF"	"10-formyl-THF"	"c, m, l, e"
"THF"	"THF"	"c, m, e, l"
"uridine"	"uridine"	"c, l, m, e"
"urate"	"urate"	"c, e"
"alloxan"	"alloxan"	"c, e"
"urea"	"urea"	"c, e, m"
"ADP-ribose"	"ADP-ribose"	"c, e"
"dTTP"	"dTTP"	"c, m, n"
"dTDP"	"dTDP"	"c, m, n"
"HCO3-"	"HCO3-"	"c, m, e"
"orotidine-5-phosphate"	"orotidine-5-phosphate"	"c"
"N-carbamoyl-L-aspartate"	"N-carbamoyl-L-aspartate"	"c"
"dTMP"	"dTMP"	"c, m, n, l"
"thymidine"	"thymidine"	"c, m, l, e"
"CMP"	"CMP"	"c, e, m, l, n, g, r"
"cytidine"	"cytidine"	"c, e, l, m"
"uracil"	"uracil"	"c, e"
"5,6-Dihydrouracil"	"5,6-Dihydrouracil"	"c"
"3-ureidopropionate"	"3-ureidopropionate"	"c"
"thymine"	"thymine"	"c, m, e"
"dihydrothymine"	"dihydrothymine"	"c, m"
"dCMP"	"dCMP"	"c, n, l"
"deoxycytidine"	"deoxycytidine"	"c, n, l, e, m"
"orotate"	"orotate"	"c"
"(S)-dihydroorotate"	"(S)-dihydroorotate"	"c"
"ubiquinone"	"ubiquinone"	"m"
"ubiquinol"	"ubiquinol"	"m"
"dUMP"	"dUMP"	"c, m, n"
"deoxyuridine"	"deoxyuridine"	"c, m, e"
"5,10-methylene-THF"	"5,10-methylene-THF"	"c, m"
"dihydrofolate"	"dihydrofolate"	"c, m, e, l"
"mitooxidizedthioredoxin"	"mitooxidizedthioredoxin"	"m"
"mitothioredoxin"	"mitothioredoxin"	"m"
"pseudouridine-5-phosphate"	"pseudouridine-5-phosphate"	"c"
"sulfate"	"sulfate"	"c, m, l, e"
"adenylylsulfate"	"adenylylsulfate"	"c"
"PAPS"	"PAPS"	"c, g"
"dITP"	"dITP"	"c, n, m"
"dIDP"	"dIDP"	"c, n, m"
"dIMP"	"dIMP"	"c"
"ADP-glucose"	"ADP-glucose"	"c"
"ADP-mannose"	"ADP-mannose"	"c"
"XTP"	"XTP"	"c"
"citrulline"	"citrulline"	"c, m, e, g"
"argininosuccinate"	"argininosuccinate"	"c"
"arginine"	"arginine"	"c, m, l, e"
"1-pyrroline-5-carboxylate"	"1-pyrroline-5-carboxylate"	"m, c"
"asparagine"	"asparagine"	"m, c, l, e"
"3-sulfinoalanine"	"3-sulfinoalanine"	"m, c"
"3-sulfinylpyruvicacid"	"3-sulfinylpyruvicacid"	"m, c"
"GSSG"	"GSSG"	"m, c, e, r"
"alanine"	"alanine"	"c, m, l, e"
"2-oxoglutaramate"	"2-oxoglutaramate"	"c, m"
"succinatesemialdehyde"	"succinatesemialdehyde"	"m"
"succinate"	"succinate"	"m, c, p, e"
"4-aminobutyrate"	"4-aminobutyrate"	"c, m, e, l"
"tyrosine"	"tyrosine"	"m, c, l, e"
"4-hydroxyphenylpyruvate"	"4-hydroxyphenylpyruvate"	"m, c"
"N-acetyl-L-asparagine"	"N-acetyl-L-asparagine"	"c"
"(S)-2-aminobutanoate"	"(S)-2-aminobutanoate"	"c"
"5-oxoproline"	"5-oxoproline"	"c"
"gamma-L-glutamyl-L-alpha-aminobutyrate"	"gamma-L-glutamyl-L-alpha-aminobutyrate"	"c"
"gamma-glutamylglutathione"	"gamma-glutamylglutathione"	"c"
"D-aspartate"	"D-aspartate"	"p, e, c"
"D-alanine"	"D-alanine"	"c, e, p, l"
"N-acetyl-L-aspartate"	"N-acetyl-L-aspartate"	"c"
"L-glutamate5-semialdehyde"	"L-glutamate5-semialdehyde"	"m, c"
"ornithine"	"ornithine"	"m, c, e"
"proline"	"proline"	"c, m, l, e"
"glutamyl-5-phosphate"	"glutamyl-5-phosphate"	"m"
"N-(omega)-hydroxyarginine"	"N-(omega)-hydroxyarginine"	"c"
"NO"	"NO"	"c, e"
"SAM"	"SAM"	"c, n, m, r"
"S-adenosylmethioninamine"	"S-adenosylmethioninamine"	"c"
"putrescine"	"putrescine"	"c, e, p"
"5-methylthioadenosine"	"5-methylthioadenosine"	"c"
"spermidine"	"spermidine"	"c, p, e"
"spermine"	"spermine"	"c, p, e"
"4-aminobutanal"	"4-aminobutanal"	"e, m, c"
"SAH"	"SAH"	"c, n, m, r"
"creatine"	"creatine"	"c, m, e"
"guanidinoacetate"	"guanidinoacetate"	"c"
"histidine"	"histidine"	"c, l, e, m"
"homocarnosine"	"homocarnosine"	"c"
"trans-4-hydroxy-L-proline"	"trans-4-hydroxy-L-proline"	"c, m"
"L-1-pyrroline-3-hydroxy-5-carboxylate"	"L-1-pyrroline-3-hydroxy-5-carboxylate"	"c, m"
"L-erythro-4-hydroxyglutamate"	"L-erythro-4-hydroxyglutamate"	"m"
"4-hydroxy-2-oxoglutarate"	"4-hydroxy-2-oxoglutarate"	"m"
"glyoxalate"	"glyoxalate"	"m, c"
"methylthioribose-1p"	"methylthioribose-1p"	"c"
"N1-acetylspermine"	"N1-acetylspermine"	"c, p"
"sperminemonoaldehyde"	"sperminemonoaldehyde"	"c, e, p"
"sperminedialdehyde"	"sperminedialdehyde"	"c, e, p"
"N1-acetylspermidine"	"N1-acetylspermidine"	"c, p"
"spermidinemonoaldehyde1"	"spermidinemonoaldehyde1"	"c, e, p"
"spermidinemonoaldehyde2"	"spermidinemonoaldehyde2"	"c, e, p"
"spermidinedialdehyde"	"spermidinedialdehyde"	"c, e, p"
"putreanine"	"putreanine"	"c"
"isoputreanine"	"isoputreanine"	"c"
"acetamidopropanal"	"acetamidopropanal"	"c, p"
"N1,N12-diacetylspermine"	"N1,N12-diacetylspermine"	"c, p"
"dehydrospermidine"	"dehydrospermidine"	"c"
"1,3-diaminopropane"	"1,3-diaminopropane"	"c"
"1-pyrroline"	"1-pyrroline"	"m, c"
"deoxyhypusine"	"deoxyhypusine"	"c"
"lysine"	"lysine"	"c, m, l, n, e"
"spermicacid1"	"spermicacid1"	"c"
"L-4-hydroxyglutamatesemialdehyde"	"L-4-hydroxyglutamatesemialdehyde"	"m"
"N-acetylornithine"	"N-acetylornithine"	"c"
"creatine-phosphate"	"creatine-phosphate"	"m, c"
"sarcosine"	"sarcosine"	"m, p, c"
"N-acetylputrescine"	"N-acetylputrescine"	"c"
"N4-acetylaminobutanal"	"N4-acetylaminobutanal"	"c"
"4-acetamidobutanoate"	"4-acetamidobutanoate"	"c"
"glycerate"	"glycerate"	"c, m"
"isobutyrylglycine"	"isobutyrylglycine"	"m"
"isobutyryl-CoA"	"isobutyryl-CoA"	"m"
"methacrylyl-CoA"	"methacrylyl-CoA"	"m"
"3-methylcrotonyl-CoA"	"3-methylcrotonyl-CoA"	"m"
"isovaleryl-CoA"	"isovaleryl-CoA"	"m"
"isovalerylglycine"	"isovalerylglycine"	"m"
"3-methylcrotonoylglycine"	"3-methylcrotonoylglycine"	"m"
"2-methylbutyryl-CoA"	"2-methylbutyryl-CoA"	"m"
"2-methylbutyrylglycine"	"2-methylbutyrylglycine"	"m"
"tiglyl-CoA"	"tiglyl-CoA"	"m"
"3-phosphonooxypyruvate"	"3-phosphonooxypyruvate"	"c"
"3-phosphoserine"	"3-phosphoserine"	"c"
"serine"	"serine"	"c, m, l, e"
"L-2-amino-3-oxobutanoicacid"	"L-2-amino-3-oxobutanoicacid"	"m"
"formaldehyde"	"formaldehyde"	"p, c, m, l"
"aminoacetone"	"aminoacetone"	"c"
"2-amino-3-oxoadipate"	"2-amino-3-oxoadipate"	"m"
"succinyl-CoA"	"succinyl-CoA"	"m, c"
"dehydroalanine"	"dehydroalanine"	"c"
"N-acetyl-L-alanine"	"N-acetyl-L-alanine"	"c"
"threonine"	"threonine"	"c, l, e"
"hydroxypyruvate"	"hydroxypyruvate"	"c"
"2-hydroxy-3-oxopropanoate"	"2-hydroxy-3-oxopropanoate"	"c"
"choline"	"choline"	"c, m, e, g, r"
"betaine_aldehyde"	"betaine_aldehyde"	"c, m"
"betaine"	"betaine"	"c, m, e"
"homocysteine"	"homocysteine"	"c"
"dimethylglycine"	"dimethylglycine"	"c, m"
"methionine"	"methionine"	"c, l, e"
"5-aminolevulinate"	"5-aminolevulinate"	"m, c"
"cys-gly"	"cys-gly"	"c, e"
"gamma-L-glutamyl-L-alanine"	"gamma-L-glutamyl-L-alanine"	"c"
"THF-hexaglutamate"	"THF-hexaglutamate"	"c"
"glycolate"	"glycolate"	"c, m"
"S-aminomethyldihydrolipoamide"	"S-aminomethyldihydrolipoamide"	"m"
"lipoylprotein"	"lipoylprotein"	"m"
"S-aminomethyldihydrolipoylprotein"	"S-aminomethyldihydrolipoylprotein"	"m"
"dihydrolipoylprotein"	"dihydrolipoylprotein"	"m"
"O-phospho-L-homoserine"	"O-phospho-L-homoserine"	"c"
"acetylcarnosine"	"acetylcarnosine"	"c"
"carnosine"	"carnosine"	"c"
"histamine"	"histamine"	"c, e"
"N-methylhistamine"	"N-methylhistamine"	"c"
"methylimidazole-acetaldehyde"	"methylimidazole-acetaldehyde"	"c"
"methylimidazoleaceticacid"	"methylimidazoleaceticacid"	"c"
"S-[2-carboxy-1-(1H-imidazol-4-yl)ethyl]glutathione"	"S-[2-carboxy-1-(1H-imidazol-4-yl)ethyl]glutathione"	"c"
"S-[2-carboxy-1-(1H-imidazol-4-yl)ethyl]-L-cysteine"	"S-[2-carboxy-1-(1H-imidazol-4-yl)ethyl]-L-cysteine"	"c"
"urocanate"	"urocanate"	"c"
"N-acetyl-S-[2-carboxy-1-(1H-imidazol-4-yl)ethyl]-L-cysteine"	"N-acetyl-S-[2-carboxy-1-(1H-imidazol-4-yl)ethyl]-L-cysteine"	"c"
"NH4"	"NH4"	"c, e, m"
"S-[2-carboxy-1-(1H-imidazol-4-yl)ethyl]-3-thiolactate"	"S-[2-carboxy-1-(1H-imidazol-4-yl)ethyl]-3-thiolactate"	"c"
"imidazole-4-acetaldehyde"	"imidazole-4-acetaldehyde"	"c, m"
"imidazole-4-acetate"	"imidazole-4-acetate"	"c, m"
"2-oxoadipate"	"2-oxoadipate"	"m, c"
"glutaryl-CoA"	"glutaryl-CoA"	"m"
"histone-N6-methyl-L-lysine"	"histone-N6-methyl-L-lysine"	"n"
"histone-L-lysine"	"histone-L-lysine"	"n, c"
"saccharopine"	"saccharopine"	"m"
"L-2-aminoadipate"	"L-2-aminoadipate"	"c, m"
"S-glutaryldihydrolipoamide"	"S-glutaryldihydrolipoamide"	"m"
"2-aminoadipate6-semialdehyde"	"2-aminoadipate6-semialdehyde"	"m, c"
"1-piperideine-6-carboxylate"	"1-piperideine-6-carboxylate"	"c, p"
"[protein]-L-lysine"	"[protein]-L-lysine"	"c, n"
"[protein]-N6-methyl-L-lysine"	"[protein]-N6-methyl-L-lysine"	"c"
"[protein]-N6,N6-dimethyl-L-lysine"	"[protein]-N6,N6-dimethyl-L-lysine"	"c, n"
"[protein]-N6,N6,N6-trimethyl-L-lysine"	"[protein]-N6,N6,N6-trimethyl-L-lysine"	"c, n, r"
"N6,N6,N6-trimethyl-L-lysine"	"N6,N6,N6-trimethyl-L-lysine"	"c, r"
"3-hydroxy-N6,N6,N6-trimethyl-L-lysine"	"3-hydroxy-N6,N6,N6-trimethyl-L-lysine"	"c"
"4-trimethylammoniobutanal"	"4-trimethylammoniobutanal"	"c"
"gamma-butyrobetaine"	"gamma-butyrobetaine"	"c"
"L-carnitine"	"L-carnitine"	"c, m, p, r, e"
"procollagen-5-hydroxy-L-lysine"	"procollagen-5-hydroxy-L-lysine"	"c"
"5-(D-galactosyloxy)-L-lysine-procollagen"	"5-(D-galactosyloxy)-L-lysine-procollagen"	"c"
"1,2-D-glucosyl-5-D-(galactosyloxy)-L-lysine-procollagen"	"1,2-D-glucosyl-5-D-(galactosyloxy)-L-lysine-procollagen"	"c"
"L-pipecolate"	"L-pipecolate"	"p"
"peptidesanslysine"	"peptidesanslysine"	"r"
"(S)-3-hydroxybutyryl-CoA"	"(S)-3-hydroxybutyryl-CoA"	"m, p"
"3-hydroxykynurenamine"	"3-hydroxykynurenamine"	"c"
"4,8-dihydroxyquinoline"	"4,8-dihydroxyquinoline"	"c"
"indole-3-acetaldehyde"	"indole-3-acetaldehyde"	"m, c"
"indoleacetate"	"indoleacetate"	"m, c"
"kynurenine"	"kynurenine"	"c"
"4-(2-aminophenyl)-2,4-dioxobutanoate"	"4-(2-aminophenyl)-2,4-dioxobutanoate"	"c"
"melatonin"	"melatonin"	"c"
"6-hydroxymelatonin"	"6-hydroxymelatonin"	"c"
"hydroxymethylglutathione"	"hydroxymethylglutathione"	"c"
"phenethylamine"	"phenethylamine"	"c"
"phenylacetaldehyde"	"phenylacetaldehyde"	"c, m"
"phenylacetate"	"phenylacetate"	"c, m"
"dopamine"	"dopamine"	"c, e, m, g"
"PAP"	"PAP"	"c, g"
"dopamine-3-O-sulfate"	"dopamine-3-O-sulfate"	"c"
"methylamine"	"methylamine"	"c"
"formylglutathione"	"formylglutathione"	"c"
"triiodothyronine"	"triiodothyronine"	"c, r, e"
"3,5,3-triiodothyronine-4-sulfate"	"3,5,3-triiodothyronine-4-sulfate"	"c"
"tyramine"	"tyramine"	"c"
"tyramine-O-sulfate"	"tyramine-O-sulfate"	"c"
"2-methylacetoacetyl-CoA"	"2-methylacetoacetyl-CoA"	"m"
"methylmalonyl-CoA"	"methylmalonyl-CoA"	"m"
"(R)-methylmalonyl-CoA"	"(R)-methylmalonyl-CoA"	"m"
"valine"	"valine"	"c, m, l, e"
"3-methyl-2-oxobutyrate"	"3-methyl-2-oxobutyrate"	"c, m"
"3-hydroxyisobutyrate"	"3-hydroxyisobutyrate"	"m"
"2-methyl-3-oxopropanoate"	"2-methyl-3-oxopropanoate"	"m, c"
"isoleucine"	"isoleucine"	"c, m, l, e"
"2-oxo-3-methylvalerate"	"2-oxo-3-methylvalerate"	"c, m"
"methylmalonate"	"methylmalonate"	"c, m"
"S-(2-methylpropanoyl)-dihydrolipoamide"	"S-(2-methylpropanoyl)-dihydrolipoamide"	"m"
"S-(2-methylbutanoyl)-dihydrolipoamide"	"S-(2-methylbutanoyl)-dihydrolipoamide"	"m"
"4-methyl-2-oxopentanoate"	"4-methyl-2-oxopentanoate"	"m, c"
"S-(3-methylbutanoyl)-dihydrolipoamide"	"S-(3-methylbutanoyl)-dihydrolipoamide"	"m"
"leucine"	"leucine"	"c, m, l, e"
"alpha-hydroxyisocaproicacid"	"alpha-hydroxyisocaproicacid"	"c"
"2-methylglutaconyl-CoA"	"2-methylglutaconyl-CoA"	"m"
"2-methylglutaconicacid"	"2-methylglutaconicacid"	"m"
"L-3-amino-isobutanoate"	"L-3-amino-isobutanoate"	"m"
"N-arachidonoylglycine"	"N-arachidonoylglycine"	"m"
"arachidonyl-CoA"	"arachidonyl-CoA"	"m, c, r, p"
"phenylalanine"	"phenylalanine"	"c, l, e"
"tetrahydrobiopterin"	"tetrahydrobiopterin"	"c, n"
"dihydrobiopterin"	"dihydrobiopterin"	"c"
"tryptophan"	"tryptophan"	"c, l, e"
"L-formylkynurenine"	"L-formylkynurenine"	"c"
"formate"	"formate"	"c, r, m, n, e"
"formylanthranilate"	"formylanthranilate"	"c"
"anthranilate"	"anthranilate"	"c"
"4-hydroxy-2-quinolinecarboxylicacid"	"4-hydroxy-2-quinolinecarboxylicacid"	"c"
"3-hydroxy-L-kynurenine"	"3-hydroxy-L-kynurenine"	"c"
"3-hydroxyanthranilate"	"3-hydroxyanthranilate"	"c"
"O2-"	"O2-"	"c, e, m, n, p"
"cinnavalininate"	"cinnavalininate"	"c"
"4-(2-amino-3-hydroxyphenyl)-2,4-dioxobutanoate"	"4-(2-amino-3-hydroxyphenyl)-2,4-dioxobutanoate"	"c"
"xanthurenate"	"xanthurenate"	"c"
"beta-carboline"	"beta-carboline"	"c"
"harman"	"harman"	"c"
"tryptamine"	"tryptamine"	"c"
"methyl-indole-3-acetate"	"methyl-indole-3-acetate"	"c"
"5-hydroxy-N-formylkynurenine"	"5-hydroxy-N-formylkynurenine"	"c"
"5-hydroxykynurenine"	"5-hydroxykynurenine"	"c"
"5-hydroxykynurenamine"	"5-hydroxykynurenamine"	"c"
"4,6-dihydroxyquinoline"	"4,6-dihydroxyquinoline"	"c"
"3-hydroxykynurenine-O-beta-D-glucoside"	"3-hydroxykynurenine-O-beta-D-glucoside"	"c"
"glutathionyl-3-hydroxykynurenineglucoside"	"glutathionyl-3-hydroxykynurenineglucoside"	"c"
"phenylpyruvate"	"phenylpyruvate"	"c"
"2-hydroxy-3-phenylpropenoate"	"2-hydroxy-3-phenylpropenoate"	"c"
"L-dopa"	"L-dopa"	"c, e"
"3-O-methyldopa"	"3-O-methyldopa"	"c"
"salsolinol"	"salsolinol"	"c"
"salsoline"	"salsoline"	"c"
"N-methylsalsolinol"	"N-methylsalsolinol"	"c"
"(R)-1,2-dimethyl-5,6-dihydroxy-tetrahydroisoquinoline"	"(R)-1,2-dimethyl-5,6-dihydroxy-tetrahydroisoquinoline"	"c"
"salsolinol-1-carboxylate"	"salsolinol-1-carboxylate"	"c"
"salsoline-1-carboxylate"	"salsoline-1-carboxylate"	"c"
"noradrenaline"	"noradrenaline"	"c, e"
"adrenaline"	"adrenaline"	"c, e"
"3,4-dihydroxymandelaldehyde"	"3,4-dihydroxymandelaldehyde"	"c"
"L-metanephrine"	"L-metanephrine"	"c"
"3-methoxy-4-hydroxyphenylglycolaldehyde"	"3-methoxy-4-hydroxyphenylglycolaldehyde"	"c"
"vanillylmandelate"	"vanillylmandelate"	"c"
"normetanephrine"	"normetanephrine"	"c"
"3,4-dihydroxymandelate"	"3,4-dihydroxymandelate"	"c"
"3,4-dihydroxyphenylethyleneglycol"	"3,4-dihydroxyphenylethyleneglycol"	"c"
"3-methoxy-4-hydroxyphenylethyleneglycol"	"3-methoxy-4-hydroxyphenylethyleneglycol"	"c"
"3,4-dihydroxyphenylacetaldehyde"	"3,4-dihydroxyphenylacetaldehyde"	"c"
"3,4-dihydroxyphenylacetate"	"3,4-dihydroxyphenylacetate"	"c"
"homovanillate"	"homovanillate"	"c"
"3-methoxytyramine"	"3-methoxytyramine"	"c"
"3-methoxy-4-hydroxyphenylacetaldehyde"	"3-methoxy-4-hydroxyphenylacetaldehyde"	"c"
"2-hydroxy-3-(4-hydroxyphenyl)propenoate"	"2-hydroxy-3-(4-hydroxyphenyl)propenoate"	"c"
"homogentisate"	"homogentisate"	"c"
"4-maleylacetoacetate"	"4-maleylacetoacetate"	"c"
"fumarylacetoacetate"	"fumarylacetoacetate"	"c"
"N-methyltyramine"	"N-methyltyramine"	"c"
"4-hydroxyphenylacetaldehyde"	"4-hydroxyphenylacetaldehyde"	"c"
"4-hydroxyphenylacetate"	"4-hydroxyphenylacetate"	"c"
"dopamine-O-quinone"	"dopamine-O-quinone"	"c"
"5-S-glutathionyl-dopamine"	"5-S-glutathionyl-dopamine"	"c"
"dopaminochrome"	"dopaminochrome"	"c"
"aminochrome-O-semiquinone"	"aminochrome-O-semiquinone"	"c"
"5-S-glutathionyl-aminochromereduced"	"5-S-glutathionyl-aminochromereduced"	"c"
"leukoaminochrome"	"leukoaminochrome"	"c"
"adrenochrome-O-semiquinone"	"adrenochrome-O-semiquinone"	"c"
"adrenochrome"	"adrenochrome"	"c"
"5-S-glutathionyl-adrenochromehydroquinone"	"5-S-glutathionyl-adrenochromehydroquinone"	"c"
"noradrenochrome-O-semiquinone"	"noradrenochrome-O-semiquinone"	"c"
"noradrenochrome"	"noradrenochrome"	"c"
"5-S-glutathionyl-noradrenochromehydroquinone"	"5-S-glutathionyl-noradrenochromehydroquinone"	"c"
"3,3-diiodo-L-thyronine"	"3,3-diiodo-L-thyronine"	"c, r"
"iodide"	"iodide"	"c, r"
"3,3-diiodo-L-thyronine-4-O-sulfate"	"3,3-diiodo-L-thyronine-4-O-sulfate"	"c"
"reversetriiodthyronine"	"reversetriiodthyronine"	"c, r, e"
"3,5-diiodo-L-thyronine"	"3,5-diiodo-L-thyronine"	"c, r"
"3-monoiodo-L-thyronine"	"3-monoiodo-L-thyronine"	"c, r"
"thyroxine"	"thyroxine"	"c, r, e"
"5-S-glutathionyl-L-dopa"	"5-S-glutathionyl-L-dopa"	"c"
"L-dopaquinone"	"L-dopaquinone"	"c"
"L-dopachrome"	"L-dopachrome"	"c"
"dopachrome-O-semiquinone"	"dopachrome-O-semiquinone"	"c"
"5-S-glutathionyl-dopachromehydroquinone"	"5-S-glutathionyl-dopachromehydroquinone"	"c"
"5,6-dihydroxyindole-2-carboxylate"	"5,6-dihydroxyindole-2-carboxylate"	"c"
"2-phenylacetamide"	"2-phenylacetamide"	"c"
"4alpha-hydroxytetrahydrobiopterin"	"4alpha-hydroxytetrahydrobiopterin"	"c, n"
"phenylacetyl-CoA"	"phenylacetyl-CoA"	"c"
"phenylacetylglycine"	"phenylacetylglycine"	"c"
"L-cystathionine"	"L-cystathionine"	"c"
"cysteine"	"cysteine"	"c, m, e, l"
"mercaptopyruvate"	"mercaptopyruvate"	"c, m"
"5-methyl-THF"	"5-methyl-THF"	"c, e"
"N-acetylmethionine"	"N-acetylmethionine"	"c"
"homocysteine-thiolactone"	"homocysteine-thiolactone"	"c"
"sulfite"	"sulfite"	"c, m"
"H2S2O3"	"H2S2O3"	"c"
"cystine"	"cystine"	"c, e"
"DNA"	"DNA"	"c, n"
"DNA-5-methylcytosine"	"DNA-5-methylcytosine"	"c, n"
"H2S"	"H2S"	"c"
"S-methyl-5-thio-D-ribulose-1-phosphate"	"S-methyl-5-thio-D-ribulose-1-phosphate"	"c"
"2,3-diketo-5-methylthiopentyl-1-phosphate"	"2,3-diketo-5-methylthiopentyl-1-phosphate"	"c"
"1,2-dihydroxy-5-(methylthio)pent-1-en-3-one"	"1,2-dihydroxy-5-(methylthio)pent-1-en-3-one"	"c"
"3-(methylthio)propionicacid"	"3-(methylthio)propionicacid"	"c"
"CO"	"CO"	"c"
"4-methylthio-2-oxobutanoicacid"	"4-methylthio-2-oxobutanoicacid"	"c"
"thiosulfate"	"thiosulfate"	"c, m"
"hydrogen-cyanide"	"hydrogen-cyanide"	"c, m"
"thiocyanate"	"thiocyanate"	"c, m"
"3-mercaptolactate"	"3-mercaptolactate"	"c"
"hypothiocyanite"	"hypothiocyanite"	"c"
"3-sulfopyruvate"	"3-sulfopyruvate"	"c, m"
"L-cysteate"	"L-cysteate"	"c, m"
"(S)-3-sulfolactate"	"(S)-3-sulfolactate"	"c, m"
"gamma-glutamyl-cysteine"	"gamma-glutamyl-cysteine"	"c"
"(5-L-glutamyl)-L-aminoacid"	"(5-L-glutamyl)-L-aminoacid"	"e"
"3-amino-propanal"	"3-amino-propanal"	"c"
"beta-alanine"	"beta-alanine"	"c, m, e"
"selenate"	"selenate"	"c"
"adenylylselenate"	"adenylylselenate"	"c"
"3-phosphoadenylylselenate"	"3-phosphoadenylylselenate"	"c"
"selenite"	"selenite"	"c"
"selenide"	"selenide"	"c"
"selenophosphate"	"selenophosphate"	"c"
"pyridoxal-phosphate"	"pyridoxal-phosphate"	"c"
"pyridoxine-phosphate"	"pyridoxine-phosphate"	"c"
"selenocysteine"	"selenocysteine"	"c"
"selenocystathionine"	"selenocystathionine"	"c"
"selenohomocysteine"	"selenohomocysteine"	"c"
"se-adenosyl-L-selenohomocysteine"	"se-adenosyl-L-selenohomocysteine"	"c, n"
"selenomethionine"	"selenomethionine"	"c"
"methaneselenol"	"methaneselenol"	"c"
"selenomethionine-se-oxide"	"selenomethionine-se-oxide"	"c"
"se-adenosylselenomethionine"	"se-adenosylselenomethionine"	"c, n"
"se-methyl-L-selenocysteine"	"se-methyl-L-selenocysteine"	"c"
"tRNA(met)"	"tRNA(met)"	"c"
"selenomethionyl-tRNA(met)"	"selenomethionyl-tRNA(met)"	"c"
"3-hydroxyisobutyryl-CoA"	"3-hydroxyisobutyryl-CoA"	"m"
"3-methylglutaconyl-CoA"	"3-methylglutaconyl-CoA"	"m"
"(S)-3-hydroxy-2-methylbutyryl-CoA"	"(S)-3-hydroxy-2-methylbutyryl-CoA"	"m"
"D-3-amino-isobutanoate"	"D-3-amino-isobutanoate"	"m"
"chitobiose"	"chitobiose"	"l"
"N-acetylglucosamine"	"N-acetylglucosamine"	"l, c"
"UDP-xylose"	"UDP-xylose"	"r, g, c"
"N-acetylglucosamine-1-phosphate"	"N-acetylglucosamine-1-phosphate"	"c"
"UDP-N-acetylglucosamine"	"UDP-N-acetylglucosamine"	"c, r, g"
"UDP-N-acetyl-D-galactosamine"	"UDP-N-acetyl-D-galactosamine"	"c, g, l, r"
"N-acetylglucosamine-6-phosphate"	"N-acetylglucosamine-6-phosphate"	"c"
"N-acetyl-D-mannosamine"	"N-acetyl-D-mannosamine"	"r, c"
"N-acetylmannosamine-6-phosphate"	"N-acetylmannosamine-6-phosphate"	"c"
"N-acetylneuraminate-9-phosphate"	"N-acetylneuraminate-9-phosphate"	"c"
"N-acetylneuraminate"	"N-acetylneuraminate"	"c, n, l"
"CMP-neuNGc"	"CMP-neuNGc"	"c"
"neungc"	"neungc"	"c"
"CMP-N-acetylneuraminate"	"CMP-N-acetylneuraminate"	"n, c, g"
"dTDP-glucose"	"dTDP-glucose"	"c"
"4,6-dideoxy-4-oxo-dTDP-D-glucose"	"4,6-dideoxy-4-oxo-dTDP-D-glucose"	"c"
"dTDP-galactose"	"dTDP-galactose"	"c"
"3-deoxy-D-glycero-D-galacto-2-nonulosonicacid-9-phosphate"	"3-deoxy-D-glycero-D-galacto-2-nonulosonicacid-9-phosphate"	"c"
"chitin-component"	"chitin-component"	"c"
"tRNA(tyr)"	"tRNA(tyr)"	"c"
"L-tyrosyl-tRNA(tyr)"	"L-tyrosyl-tRNA(tyr)"	"c"
"tRNA(ala)"	"tRNA(ala)"	"c"
"L-alanyl-tRNA(ala)"	"L-alanyl-tRNA(ala)"	"c"
"tRNA(arg)"	"tRNA(arg)"	"c"
"L-arginyl-tRNA(arg)"	"L-arginyl-tRNA(arg)"	"c"
"tRNA(asn)"	"tRNA(asn)"	"c"
"L-asparaginyl-tRNA(asn)"	"L-asparaginyl-tRNA(asn)"	"c"
"tRNA(asp)"	"tRNA(asp)"	"c"
"L-aspartyl-tRNA(asp)"	"L-aspartyl-tRNA(asp)"	"c"
"tRNA(cys)"	"tRNA(cys)"	"c"
"L-cysteinyl-tRNA(cys)"	"L-cysteinyl-tRNA(cys)"	"c"
"tRNA(gln)"	"tRNA(gln)"	"c"
"L-glutaminyl-tRNA(gln)"	"L-glutaminyl-tRNA(gln)"	"c"
"tRNA(glu)"	"tRNA(glu)"	"c"
"L-glutamyl-tRNA(glu)"	"L-glutamyl-tRNA(glu)"	"c"
"tRNA(gly)"	"tRNA(gly)"	"c"
"glycyl-tRNA(gly)"	"glycyl-tRNA(gly)"	"c"
"tRNA(his)"	"tRNA(his)"	"c"
"L-histidyl-tRNA(his)"	"L-histidyl-tRNA(his)"	"c"
"tRNA(ile)"	"tRNA(ile)"	"c"
"L-isoleucyl-tRNA(ile)"	"L-isoleucyl-tRNA(ile)"	"c"
"tRNA(leu)"	"tRNA(leu)"	"c"
"L-leucyl-tRNA(leu)"	"L-leucyl-tRNA(leu)"	"c"
"tRNA(lys)"	"tRNA(lys)"	"c"
"L-lysyl-tRNA(lys)"	"L-lysyl-tRNA(lys)"	"c"
"L-methionyl-tRNA(met)"	"L-methionyl-tRNA(met)"	"c"
"N-formylmethionyl-tRNA"	"N-formylmethionyl-tRNA"	"c"
"tRNA(phe)"	"tRNA(phe)"	"c"
"L-phenylalanyl-tRNA(phe)"	"L-phenylalanyl-tRNA(phe)"	"c"
"tRNA(pro)"	"tRNA(pro)"	"c"
"L-prolyl-tRNA(pro)"	"L-prolyl-tRNA(pro)"	"c"
"tRNA(ser)"	"tRNA(ser)"	"c"
"L-seryl-tRNA(ser)"	"L-seryl-tRNA(ser)"	"c"
"tRNA(thr)"	"tRNA(thr)"	"c"
"L-threonyl-tRNA(thr)"	"L-threonyl-tRNA(thr)"	"c"
"tRNA(trp)"	"tRNA(trp)"	"c"
"L-tryptophanyl-tRNA(trp)"	"L-tryptophanyl-tRNA(trp)"	"c"
"tRNA(val)"	"tRNA(val)"	"c"
"L-valyl-tRNA(val)"	"L-valyl-tRNA(val)"	"c"
"T-antigen"	"T-antigen"	"g"
"sialyl-Tantigen"	"sialyl-Tantigen"	"g"
"Tn-antigen"	"Tn-antigen"	"g, l"
"G00031"	"G00031"	"g"
"G00032"	"G00032"	"g"
"[protein]-L-serine"	"[protein]-L-serine"	"g, c, r, l"
"core2"	"core2"	"g"
"trans,trans,cis-geranyl-geranyl-pp"	"trans,trans,cis-geranyl-geranyl-pp"	"c"
"dimethylallyl-PP"	"dimethylallyl-PP"	"c"
"farnesyl-PP"	"farnesyl-PP"	"c"
"dolichyl-diphosphate"	"dolichyl-diphosphate"	"c, r"
"dolichyl-phosphate"	"dolichyl-phosphate"	"c, r"
"dolichol"	"dolichol"	"c"
"N-acetyl-D-glucosaminyldiphosphodolichol"	"N-acetyl-D-glucosaminyldiphosphodolichol"	"c"
"N,N-chitobiosyldiphosphodolichol"	"N,N-chitobiosyldiphosphodolichol"	"c"
"beta-D-mannosyldiacetylchitobiosyldiphosphodolichol"	"beta-D-mannosyldiacetylchitobiosyldiphosphodolichol"	"c"
"alpha-D-mannosyl-beta-D-mannosyl-diacetylchitobiosyldiphosphodolichol"	"alpha-D-mannosyl-beta-D-mannosyl-diacetylchitobiosyldiphosphodolichol"	"c"
"G00005"	"G00005"	"c"
"G10526"	"G10526"	"c"
"G00006"	"G00006"	"c, r"
"dolichyl-phosphate-D-mannose"	"dolichyl-phosphate-D-mannose"	"c, r"
"G10595"	"G10595"	"r"
"G10596"	"G10596"	"r"
"G10597"	"G10597"	"r"
"G00007"	"G00007"	"r"
"dolichyl-D-glucosyl-phosphate"	"dolichyl-D-glucosyl-phosphate"	"r"
"G10598"	"G10598"	"r"
"G10599"	"G10599"	"r"
"(Glc)3(GlcNAc)2(Man)9(PP-Dol)1"	"(Glc)3(GlcNAc)2(Man)9(PP-Dol)1"	"r"
"[protein]-L-asparagine"	"[protein]-L-asparagine"	"r, l"
"(alpha-D-Glucosyl)3-(alpha-D-mannosyl)8-beta-D-mannosyl-diacetylchitobiosyl-L-asparagine(protein)"	"(alpha-D-Glucosyl)3-(alpha-D-mannosyl)8-beta-D-mannosyl-diacetylchitobiosyl-L-asparagine(protein)"	"r"
"(alpha-D-Glucosyl)2-(alpha-D-mannosyl)8-beta-D-mannosyl-diacetylchitobiosyl-L-asparagine(protein)"	"(alpha-D-Glucosyl)2-(alpha-D-mannosyl)8-beta-D-mannosyl-diacetylchitobiosyl-L-asparagine(protein)"	"r"
"(alpha-D-Glucosyl)-(alpha-D-mannosyl)8-beta-D-mannosyl-diacetylchitobiosyl-L-asparagine(protein)"	"(alpha-D-Glucosyl)-(alpha-D-mannosyl)8-beta-D-mannosyl-diacetylchitobiosyl-L-asparagine(protein)"	"r"
"glucosyl-(alpha-D-mannosyl)7-beta-D-mannosyl-diacetylchitobiosyl-L-asparagine,isoformB(protein)"	"glucosyl-(alpha-D-mannosyl)7-beta-D-mannosyl-diacetylchitobiosyl-L-asparagine,isoformB(protein)"	"r"
"glucosyl-(alpha-D-mannosyl)7-beta-D-mannosyl-diacetylchitobiosyl-L-asparagine,isoformC(protein)"	"glucosyl-(alpha-D-mannosyl)7-beta-D-mannosyl-diacetylchitobiosyl-L-asparagine,isoformC(protein)"	"r"
"glucosyl-(alpha-D-mannosyl)6-beta-D-mannosyl-diacetylchitobiosyl-L-asparagine(protein)"	"glucosyl-(alpha-D-mannosyl)6-beta-D-mannosyl-diacetylchitobiosyl-L-asparagine(protein)"	"r"
"(alpha-D-mannosyl)8-beta-D-mannosyl-diacetylchitobiosyl-L-asparagine(protein)"	"(alpha-D-mannosyl)8-beta-D-mannosyl-diacetylchitobiosyl-L-asparagine(protein)"	"r, g"
"(alpha-D-mannosyl)7-beta-D-mannosyl-diacetylchitobiosyl-L-asparagine,isoformB(protein)"	"(alpha-D-mannosyl)7-beta-D-mannosyl-diacetylchitobiosyl-L-asparagine,isoformB(protein)"	"r, g"
"(alpha-D-mannosyl)7-beta-D-mannosyl-diacetylchitobiosyl-L-asparagine,isoformA(protein)"	"(alpha-D-mannosyl)7-beta-D-mannosyl-diacetylchitobiosyl-L-asparagine,isoformA(protein)"	"g"
"(alpha-D-mannosyl)7-beta-D-mannosyl-diacetylchitobiosyl-L-asparagine,isoformC(protein)"	"(alpha-D-mannosyl)7-beta-D-mannosyl-diacetylchitobiosyl-L-asparagine,isoformC(protein)"	"g"
"(alpha-D-mannosyl)6-beta-D-mannosyl-diacetylchitobiosyl-L-asparagine(protein)(A)"	"(alpha-D-mannosyl)6-beta-D-mannosyl-diacetylchitobiosyl-L-asparagine(protein)(A)"	"g"
"(alpha-D-mannosyl)6-beta-D-mannosyl-diacetylchitobiosyl-L-asparagine(protein)(B1)"	"(alpha-D-mannosyl)6-beta-D-mannosyl-diacetylchitobiosyl-L-asparagine(protein)(B1)"	"g"
"(alpha-D-mannosyl)6-beta-D-mannosyl-diacetylchitobiosyl-L-asparagine(protein)(B2)"	"(alpha-D-mannosyl)6-beta-D-mannosyl-diacetylchitobiosyl-L-asparagine(protein)(B2)"	"g"
"(alpha-D-mannosyl)6-beta-D-mannosyl-diacetylchitobiosyl-L-asparagine(protein)(C)"	"(alpha-D-mannosyl)6-beta-D-mannosyl-diacetylchitobiosyl-L-asparagine(protein)(C)"	"g"
"(alpha-D-mannosyl)5-beta-D-mannosyl-diacetylchitobiosyl-L-asparagine(protein)(C)"	"(alpha-D-mannosyl)5-beta-D-mannosyl-diacetylchitobiosyl-L-asparagine(protein)(C)"	"g"
"(alpha-D-mannosyl)5-beta-D-mannosyl-diacetylchitobiosyl-L-asparagine(protein)(B1)"	"(alpha-D-mannosyl)5-beta-D-mannosyl-diacetylchitobiosyl-L-asparagine(protein)(B1)"	"g"
"(alpha-D-mannosyl)5-beta-D-mannosyl-diacetylchitobiosyl-L-asparagine(protein)(B2)"	"(alpha-D-mannosyl)5-beta-D-mannosyl-diacetylchitobiosyl-L-asparagine(protein)(B2)"	"g"
"(alpha-D-mannosyl)4-beta-D-mannosyl-diacetylchitobiosyl-L-asparagine(protein)"	"(alpha-D-mannosyl)4-beta-D-mannosyl-diacetylchitobiosyl-L-asparagine(protein)"	"g"
"nm4masn"	"nm4masn"	"g"
"nm2masn"	"nm2masn"	"g"
"n2m2masn"	"n2m2masn"	"g"
"n2m2nmasn"	"n2m2nmasn"	"g, l"
"G00020"	"G00020"	"g"
"G00021"	"G00021"	"g"
"G00022"	"G00022"	"g"
"fn2m2masn"	"fn2m2masn"	"g"
"l2fn2m2masn"	"l2fn2m2masn"	"g"
"PA6"	"PA6"	"g, e, l"
"(alpha-D-mannosyl)2-beta-D-mannosyl-N-acetylglucosamine"	"(alpha-D-mannosyl)2-beta-D-mannosyl-N-acetylglucosamine"	"l"
"beta-1,4-mannose-N-acetylglucosamine"	"beta-1,4-mannose-N-acetylglucosamine"	"l"
"de-FucformofPA6"	"de-FucformofPA6"	"l, e"
"de-FucformofPA6(wopeptidelinkage)"	"de-FucformofPA6(wopeptidelinkage)"	"l"
"de-Fuc,GlcNAcremovedPA6(wopeptidelinkage)"	"de-Fuc,GlcNAcremovedPA6(wopeptidelinkage)"	"l"
"l2n2m2mn"	"l2n2m2mn"	"l"
"n2m2mn"	"n2m2mn"	"l"
"n2m2nm"	"n2m2nm"	"l"
"n2m2nmn"	"n2m2nmn"	"l"
"n3m2masn"	"n3m2masn"	"g"
"n4m2masn"	"n4m2masn"	"g"
"apoA1"	"apoA1"	"c, l"
"[protein]-L-tyrosine"	"[protein]-L-tyrosine"	"c"
"[protein]-tyrosine-phosphate"	"[protein]-tyrosine-phosphate"	"c"
"[protein]-tyrosine-O-sulfate"	"[protein]-tyrosine-O-sulfate"	"c"
"[protein]-L-arginine"	"[protein]-L-arginine"	"c"
"[protein]-L-citrulline"	"[protein]-L-citrulline"	"c"
"[protein]-omega-N-(ADP-D-ribosyl)-L-arginine"	"[protein]-omega-N-(ADP-D-ribosyl)-L-arginine"	"c"
"N(omega)-(ADP-D-ribosyl)-L-arginine"	"N(omega)-(ADP-D-ribosyl)-L-arginine"	"c"
"albumin"	"albumin"	"l"
"antichymotrypsin"	"antichymotrypsin"	"l"
"antitrypsin"	"antitrypsin"	"l"
"apoB100"	"apoB100"	"l"
"fibrinogen"	"fibrinogen"	"l"
"haptoglobin"	"haptoglobin"	"l"
"plasminogen"	"plasminogen"	"l"
"prothrombin"	"prothrombin"	"l"
"[apotransferin]"	"[apotransferin]"	"l"
"apoE"	"apoE"	"l"
"STAR"	"STAR"	"l, c"
"GM2A"	"GM2A"	"l"
"apocytochrome-C"	"apocytochrome-C"	"l, m"
"PPARA"	"PPARA"	"l, n"
"apoB48"	"apoB48"	"l"
"carbonate"	"carbonate"	"e, c"
"activatedmethylgroup"	"activatedmethylgroup"	"c"
"itaconate"	"itaconate"	"m"
"itaconyl-CoA"	"itaconyl-CoA"	"m"
"mesaconyl-CoA"	"mesaconyl-CoA"	"m"
"mesaconate"	"mesaconate"	"m"
"isocitrate"	"isocitrate"	"c, m, p"
"oxalosuccinate"	"oxalosuccinate"	"c, m, p"
"citrate"	"citrate"	"m, c, e"
"thiamin-PP"	"thiamin-PP"	"m, c"
"3-carboxy-1-hydroxypropyl-ThPP"	"3-carboxy-1-hydroxypropyl-ThPP"	"m"
"cis-aconitate"	"cis-aconitate"	"m, c"
"S-succinyldihydrolipoamide"	"S-succinyldihydrolipoamide"	"m"
"D-xylulose-1-phosphate"	"D-xylulose-1-phosphate"	"c"
"glycolaldehyde"	"glycolaldehyde"	"c, m"
"oxalate"	"oxalate"	"c, e, m"
"butyrate"	"butyrate"	"c, e"
"pentanoyl-CoA"	"pentanoyl-CoA"	"c, m"
"valericacid"	"valericacid"	"c, e"
"hexanoyl-CoA"	"hexanoyl-CoA"	"c, p, m"
"hexanoicacid"	"hexanoicacid"	"c, e"
"heptanoyl-CoA"	"heptanoyl-CoA"	"c, m"
"heptylicacid"	"heptylicacid"	"c, e"
"octanoyl-CoA"	"octanoyl-CoA"	"c, m, p"
"octanoicacid"	"octanoicacid"	"c, e"
"nonanoyl-CoA"	"nonanoyl-CoA"	"c, m"
"nonanoicacid"	"nonanoicacid"	"c, e"
"decanoyl-CoA"	"decanoyl-CoA"	"c, p, m"
"decanoicacid"	"decanoicacid"	"c, e"
"undecanoyl-CoA"	"undecanoyl-CoA"	"c, m"
"undecylicacid"	"undecylicacid"	"c, e"
"lauroyl-CoA"	"lauroyl-CoA"	"c, r, m, p"
"lauricacid"	"lauricacid"	"c, r, l, e"
"tridecanoyl-CoA"	"tridecanoyl-CoA"	"c, r, m"
"tridecylicacid"	"tridecylicacid"	"c, r, l, e"
"myristoyl-CoA"	"myristoyl-CoA"	"c, r, m, p"
"myristicacid"	"myristicacid"	"c, r, l, e"
"(9E)-tetradecenoicacid"	"(9E)-tetradecenoicacid"	"c, r, l, e"
"(9E)-tetradecenoyl-CoA"	"(9E)-tetradecenoyl-CoA"	"c, r, m"
"(7Z)-tetradecenoicacid"	"(7Z)-tetradecenoicacid"	"c, r, l, e"
"(7Z)-tetradecenoyl-CoA"	"(7Z)-tetradecenoyl-CoA"	"c, r, m, p"
"5-tetradecenoyl-CoA"	"5-tetradecenoyl-CoA"	"c, r, m, p"
"physetericacid"	"physetericacid"	"c, r, l, e"
"pentadecanoyl-CoA"	"pentadecanoyl-CoA"	"c, r, m"
"pentadecylicacid"	"pentadecylicacid"	"c, r, l, e"
"palmitoyl-CoA"	"palmitoyl-CoA"	"c, r, p, m"
"palmitate"	"palmitate"	"c, r, p, l, e"
"palmitoleoyl-CoA"	"palmitoleoyl-CoA"	"c, r, m, p"
"palmitolate"	"palmitolate"	"c, r, l, e"
"7-hexadecenoyl-CoA"	"7-hexadecenoyl-CoA"	"c, r, m, p"
"7-palmitoleicacid"	"7-palmitoleicacid"	"c, r, l, e"
"heptadecanoyl-CoA"	"heptadecanoyl-CoA"	"c, r, m"
"margaricacid"	"margaricacid"	"c, r, l, e"
"(10Z)-heptadecenoicacid"	"(10Z)-heptadecenoicacid"	"c, r, l, e"
"(10Z)-heptadecenoyl-CoA"	"(10Z)-heptadecenoyl-CoA"	"c, r, m"
"9-heptadecenoyl-CoA"	"9-heptadecenoyl-CoA"	"c, r, m"
"9-heptadecylenicacid"	"9-heptadecylenicacid"	"c, r, l, e"
"stearoyl-CoA"	"stearoyl-CoA"	"c, r, m, p"
"stearate"	"stearate"	"c, r, l, e"
"(13Z)-octadecenoicacid"	"(13Z)-octadecenoicacid"	"c, r, l, e"
"(13Z)-octadecenoyl-CoA"	"(13Z)-octadecenoyl-CoA"	"c, r, m"
"cis-vaccenoyl-CoA"	"cis-vaccenoyl-CoA"	"c, r, m, p"
"cis-vaccenicacid"	"cis-vaccenicacid"	"c, r, l, e"
"oleate"	"oleate"	"c, r, l, e"
"oleoyl-CoA"	"oleoyl-CoA"	"c, r, m, p"
"(9E)-octadecenoyl-CoA"	"(9E)-octadecenoyl-CoA"	"c, r, m"
"elaidate"	"elaidate"	"c, r, l, e"
"(7Z)-octadecenoicacid"	"(7Z)-octadecenoicacid"	"c, l, r, e"
"(6Z,9Z)-octadecadienoicacid"	"(6Z,9Z)-octadecadienoicacid"	"c, r, l, e"
"(6Z,9Z)-octadecadienoyl-CoA"	"(6Z,9Z)-octadecadienoyl-CoA"	"c, r, m"
"nonadecanoyl-CoA"	"nonadecanoyl-CoA"	"c, r, m"
"nonadecylicacid"	"nonadecylicacid"	"c, r, l, e"
"eicosanoyl-CoA"	"eicosanoyl-CoA"	"c, r, m, p"
"eicosanoate"	"eicosanoate"	"c, r, l, e"
"(13Z)-eicosenoicacid"	"(13Z)-eicosenoicacid"	"c, r, l, e"
"(13Z)-eicosenoyl-CoA"	"(13Z)-eicosenoyl-CoA"	"c, r, m, p"
"(11Z)-eicosenoyl-CoA"	"(11Z)-eicosenoyl-CoA"	"c, r, m, p"
"cis-gondoicacid"	"cis-gondoicacid"	"c, r, l, e"
"9-eicosenoicacid"	"9-eicosenoicacid"	"c, r, l, e"
"9-eicosenoyl-CoA"	"9-eicosenoyl-CoA"	"c, r, m"
"(8Z,11Z)-eicosadienoyl-CoA"	"(8Z,11Z)-eicosadienoyl-CoA"	"c, r, m"
"8,11-eicosadienoicacid"	"8,11-eicosadienoicacid"	"c, r, l, e"
"(5Z,8Z,11Z)-eicosatrienoyl-CoA"	"(5Z,8Z,11Z)-eicosatrienoyl-CoA"	"c, r, m"
"meadacid"	"meadacid"	"c, r, l, e"
"heneicosanoyl-CoA"	"heneicosanoyl-CoA"	"c, r, m"
"henicosanoicacid"	"henicosanoicacid"	"c, r, l, e"
"docosanoyl-CoA"	"docosanoyl-CoA"	"c, r, m, p"
"behenicacid"	"behenicacid"	"c, r, l, e"
"(13Z)-docosenoyl-CoA"	"(13Z)-docosenoyl-CoA"	"c, r, m, p"
"cis-erucicacid"	"cis-erucicacid"	"c, r, l, e"
"(11Z)-docosenoyl-CoA"	"(11Z)-docosenoyl-CoA"	"c, r, m"
"cis-cetoleicacid"	"cis-cetoleicacid"	"c, r, l, e"
"tricosanoyl-CoA"	"tricosanoyl-CoA"	"c, r"
"tricosanoicacid"	"tricosanoicacid"	"c, r, l, e"
"tetracosanoyl-CoA"	"tetracosanoyl-CoA"	"c, r, p"
"lignocerate"	"lignocerate"	"c, r, l, e"
"(15Z)-tetracosenoyl-CoA"	"(15Z)-tetracosenoyl-CoA"	"c, r, p"
"nervonicacid"	"nervonicacid"	"c, r, l, e"
"hexacosanoyl-CoA"	"hexacosanoyl-CoA"	"c, r, p"
"ceroticacid"	"ceroticacid"	"c, r, l, e"
"hexacosenoyl-CoA"	"hexacosenoyl-CoA"	"c, r, p"
"ximenicacid"	"ximenicacid"	"c, r, l, e"
"linolenoyl-CoA"	"linolenoyl-CoA"	"c, r, m"
"linolenate"	"linolenate"	"c, r, l, e"
"(6Z,9Z,12Z,15Z)-octadecatetraenoyl-CoA"	"(6Z,9Z,12Z,15Z)-octadecatetraenoyl-CoA"	"c, r, m"
"stearidonicacid"	"stearidonicacid"	"c, r, l, e"
"(8Z,11Z,14Z,17Z)-eicosatetraenoyl-CoA"	"(8Z,11Z,14Z,17Z)-eicosatetraenoyl-CoA"	"c, r, m"
"omega-3-arachidonicacid"	"omega-3-arachidonicacid"	"c, r, l, e"
"(5Z,8Z,11Z,14Z,17Z)-eicosapentaenoyl-CoA"	"(5Z,8Z,11Z,14Z,17Z)-eicosapentaenoyl-CoA"	"c, r, m"
"EPA"	"EPA"	"c, r, n, p, l, e"
"(7Z,10Z,13Z,16Z,19Z)-docosapentaenoyl-CoA"	"(7Z,10Z,13Z,16Z,19Z)-docosapentaenoyl-CoA"	"c, r, m"
"DPA"	"DPA"	"c, r, l, e"
"(9Z,12Z,15Z,18Z,21Z)-TPA"	"(9Z,12Z,15Z,18Z,21Z)-TPA"	"c, r, l, e"
"(9Z,12Z,15Z,18Z,21Z)-tetracosapentaenoyl-CoA"	"(9Z,12Z,15Z,18Z,21Z)-tetracosapentaenoyl-CoA"	"c, r"
"(6Z,9Z,12Z,15Z,18Z,21Z)-THA"	"(6Z,9Z,12Z,15Z,18Z,21Z)-THA"	"c, r, l, e"
"(6Z,9Z,12Z,15Z,18Z,21Z)-tetracosahexaenoyl-CoA"	"(6Z,9Z,12Z,15Z,18Z,21Z)-tetracosahexaenoyl-CoA"	"c, r, p"
"(4Z,7Z,10Z,13Z,16Z,19Z)-docosahexaenoyl-CoA"	"(4Z,7Z,10Z,13Z,16Z,19Z)-docosahexaenoyl-CoA"	"c, r, p, m"
"DHA"	"DHA"	"c, r, l, e"
"(11Z,14Z,17Z)-eicosatrienoicacid"	"(11Z,14Z,17Z)-eicosatrienoicacid"	"c, r, l, e"
"(11Z,14Z,17Z)-eicosatrienoyl-CoA"	"(11Z,14Z,17Z)-eicosatrienoyl-CoA"	"c, r, m"
"13,16,19-docosatrienoicacid"	"13,16,19-docosatrienoicacid"	"c, r, l, e"
"13,16,19-docosatrienoyl-CoA"	"13,16,19-docosatrienoyl-CoA"	"c, r, m"
"10,13,16,19-docosatetraenoicacid"	"10,13,16,19-docosatetraenoicacid"	"c, l, r, e"
"10,13,16,19-docosatetraenoyl-CoA"	"10,13,16,19-docosatetraenoyl-CoA"	"c, m, r"
"12,15,18,21-tetracosatetraenoicacid"	"12,15,18,21-tetracosatetraenoicacid"	"c, l, r, e"
"12,15,18,21-tetracosatetraenoyl-CoA"	"12,15,18,21-tetracosatetraenoyl-CoA"	"c, r"
"linoleoyl-CoA"	"linoleoyl-CoA"	"c, r, m, p"
"linoleate"	"linoleate"	"c, r, l, e"
"gamma-linolenoyl-CoA"	"gamma-linolenoyl-CoA"	"c, r, m, p"
"gamma-linolenate"	"gamma-linolenate"	"c, r, l, e"
"dihomo-gamma-linolenoyl-CoA"	"dihomo-gamma-linolenoyl-CoA"	"c, r, m"
"dihomo-gamma-linolenate"	"dihomo-gamma-linolenate"	"c, r, l, e"
"arachidonate"	"arachidonate"	"c, r, p, e, l"
"(7Z,10Z,13Z,16Z)-docosatetraenoyl-CoA"	"(7Z,10Z,13Z,16Z)-docosatetraenoyl-CoA"	"c, r, m"
"adrenicacid"	"adrenicacid"	"c, r, l, e"
"(9Z,12Z,15Z,18Z)-TTA"	"(9Z,12Z,15Z,18Z)-TTA"	"c, r, l, e"
"(9Z,12Z,15Z,18Z)-tetracosatetraenoyl-CoA"	"(9Z,12Z,15Z,18Z)-tetracosatetraenoyl-CoA"	"c, r"
"(6Z,9Z,12Z,15Z,18Z)-TPA"	"(6Z,9Z,12Z,15Z,18Z)-TPA"	"c, r, l, e"
"(6Z,9Z,12Z,15Z,18Z)-tetracosapentaenoyl-CoA"	"(6Z,9Z,12Z,15Z,18Z)-tetracosapentaenoyl-CoA"	"c, r, p"
"(4Z,7Z,10Z,13Z,16Z)-DPA"	"(4Z,7Z,10Z,13Z,16Z)-DPA"	"c, r, l, e"
"(4Z,7Z,10Z,13Z,16Z)-docosapentaenoyl-CoA"	"(4Z,7Z,10Z,13Z,16Z)-docosapentaenoyl-CoA"	"c, r, p, m"
"(11Z,14Z)-eicosadienoicacid"	"(11Z,14Z)-eicosadienoicacid"	"c, r, l, e"
"(11Z,14Z)-eicosadienoyl-CoA"	"(11Z,14Z)-eicosadienoyl-CoA"	"c, r, m"
"(13Z,16Z)-docosadienoicacid"	"(13Z,16Z)-docosadienoicacid"	"c, r, l, e"
"(13Z,16Z)-docosadienoyl-CoA"	"(13Z,16Z)-docosadienoyl-CoA"	"c, r, m"
"10,13,16-docosatrienoyl-CoA"	"10,13,16-docosatrienoyl-CoA"	"c, m, r"
"10,13,16-docosatriynoicacid"	"10,13,16-docosatriynoicacid"	"c, l, r, e"
"acetyl-[ACP]"	"acetyl-[ACP]"	"c"
"malonyl-[ACP]"	"malonyl-[ACP]"	"c"
"[ACP]"	"[ACP]"	"c"
"acetoacetyl-[ACP]"	"acetoacetyl-[ACP]"	"c"
"(R)-3-hydroxybutanoyl-[ACP]"	"(R)-3-hydroxybutanoyl-[ACP]"	"c"
"but-2-enoyl-[ACP]"	"but-2-enoyl-[ACP]"	"c"
"butyryl-[ACP]"	"butyryl-[ACP]"	"c"
"3-oxohexanoyl-[ACP]"	"3-oxohexanoyl-[ACP]"	"c"
"D-3-hydroxyhexanoyl-[ACP]"	"D-3-hydroxyhexanoyl-[ACP]"	"c"
"(2E)-hexenoyl-[ACP]"	"(2E)-hexenoyl-[ACP]"	"c"
"hexanoyl-[ACP]"	"hexanoyl-[ACP]"	"c"
"3-oxooctanoyl-[ACP]"	"3-oxooctanoyl-[ACP]"	"c"
"(R)-3-hydroxyoctanoyl-[ACP]"	"(R)-3-hydroxyoctanoyl-[ACP]"	"c"
"(2E)-octenoyl-[ACP]"	"(2E)-octenoyl-[ACP]"	"c"
"octanoyl-[ACP]"	"octanoyl-[ACP]"	"c"
"3-oxodecanoyl-[ACP]"	"3-oxodecanoyl-[ACP]"	"c"
"(R)-3-hydroxydecanoyl-[ACP]"	"(R)-3-hydroxydecanoyl-[ACP]"	"c"
"(2E)-decenoyl-[ACP]"	"(2E)-decenoyl-[ACP]"	"c"
"decanoyl-[ACP]"	"decanoyl-[ACP]"	"c"
"3-oxododecanoyl-[ACP]"	"3-oxododecanoyl-[ACP]"	"c"
"D-3-hydroxydodecanoyl-[ACP]"	"D-3-hydroxydodecanoyl-[ACP]"	"c"
"(2E)-dodecenoyl-[ACP]"	"(2E)-dodecenoyl-[ACP]"	"c"
"dodecanoyl-[ACP]"	"dodecanoyl-[ACP]"	"c"
"3-oxotetradecanoyl-[ACP]"	"3-oxotetradecanoyl-[ACP]"	"c"
"HMA"	"HMA"	"c"
"(2E)-tetradecenoyl-[ACP]"	"(2E)-tetradecenoyl-[ACP]"	"c"
"tetradecanoyl-[ACP]"	"tetradecanoyl-[ACP]"	"c"
"3-oxohexadecanoyl-[ACP]"	"3-oxohexadecanoyl-[ACP]"	"c"
"(R)-3-hydroxypalmitoyl-[ACP]"	"(R)-3-hydroxypalmitoyl-[ACP]"	"c"
"(2E)-hexadecenoyl-[ACP]"	"(2E)-hexadecenoyl-[ACP]"	"c"
"hexadecanoyl-[ACP]"	"hexadecanoyl-[ACP]"	"c"
"propanoyl-[ACP]"	"propanoyl-[ACP]"	"c"
"3-oxopentanoyl-[ACP]"	"3-oxopentanoyl-[ACP]"	"c"
"3-hydroxypentanoyl-[ACP]"	"3-hydroxypentanoyl-[ACP]"	"c"
"(2E)-pentenoyl-[ACP]"	"(2E)-pentenoyl-[ACP]"	"c"
"pentanoyl-[ACP]"	"pentanoyl-[ACP]"	"c"
"3-oxoheptanoyl-[ACP]"	"3-oxoheptanoyl-[ACP]"	"c"
"3-hydroxyheptanoyl-[ACP]"	"3-hydroxyheptanoyl-[ACP]"	"c"
"(2E)-heptenoyl-[ACP]"	"(2E)-heptenoyl-[ACP]"	"c"
"heptanoyl-[ACP]"	"heptanoyl-[ACP]"	"c"
"3-oxononanoyl-[ACP]"	"3-oxononanoyl-[ACP]"	"c"
"3-hydroxynonanoyl-[ACP]"	"3-hydroxynonanoyl-[ACP]"	"c"
"(2E)-nonenoyl-[ACP]"	"(2E)-nonenoyl-[ACP]"	"c"
"nonanoyl-[ACP]"	"nonanoyl-[ACP]"	"c"
"3-oxoundecanoyl-[ACP]"	"3-oxoundecanoyl-[ACP]"	"c"
"3-hydroxyundecanoyl-[ACP]"	"3-hydroxyundecanoyl-[ACP]"	"c"
"(2E)-undecenoyl-[ACP]"	"(2E)-undecenoyl-[ACP]"	"c"
"undecanoyl-[ACP]"	"undecanoyl-[ACP]"	"c"
"3-oxotridecanoyl-[ACP]"	"3-oxotridecanoyl-[ACP]"	"c"
"3-hydroxytridecanoyl-[ACP]"	"3-hydroxytridecanoyl-[ACP]"	"c"
"(2E)-tridecenoyl-[ACP]"	"(2E)-tridecenoyl-[ACP]"	"c"
"tridecanoyl-[ACP]"	"tridecanoyl-[ACP]"	"c"
"3-oxopentadecanoyl-[ACP]"	"3-oxopentadecanoyl-[ACP]"	"c"
"3-hydroxypentadecanoyl-[ACP]"	"3-hydroxypentadecanoyl-[ACP]"	"c"
"(2E)-pentadecenoyl-[ACP]"	"(2E)-pentadecenoyl-[ACP]"	"c"
"pentadecanoyl-[ACP]"	"pentadecanoyl-[ACP]"	"c"
"3-oxoheptadecanoyl-[ACP]"	"3-oxoheptadecanoyl-[ACP]"	"c"
"3-hydroxyheptadecanoyl-[ACP]"	"3-hydroxyheptadecanoyl-[ACP]"	"c"
"(2E)-heptadecenoyl-[ACP]"	"(2E)-heptadecenoyl-[ACP]"	"c"
"heptadecanoyl-[ACP]"	"heptadecanoyl-[ACP]"	"c"
"3-oxo-11-cis-eicosenoyl-CoA"	"3-oxo-11-cis-eicosenoyl-CoA"	"c, p, m"
"3(S)-hydroxy-11-cis-eicosenoyl-CoA"	"3(S)-hydroxy-11-cis-eicosenoyl-CoA"	"c, p, m"
"trans,cis-2,11-eicosadienoyl-CoA"	"trans,cis-2,11-eicosadienoyl-CoA"	"c, p, m"
"3-oxo-13cis-docosenoyl-CoA"	"3-oxo-13cis-docosenoyl-CoA"	"c, p, m"
"3(S)-hydroxy-13-cis-docosenoyl-CoA"	"3(S)-hydroxy-13-cis-docosenoyl-CoA"	"c, p, m"
"trans,cis-2,13-docosadienoyl-CoA"	"trans,cis-2,13-docosadienoyl-CoA"	"c, p, m"
"3-oxo-cis-15-tetracosaenoyl-CoA"	"3-oxo-cis-15-tetracosaenoyl-CoA"	"c, p"
"3(S)-hydroxy-cis-15-tetracosaenoyl-CoA"	"3(S)-hydroxy-cis-15-tetracosaenoyl-CoA"	"c, p"
"trans,cis-2,15-tetracosadienoyl-CoA"	"trans,cis-2,15-tetracosadienoyl-CoA"	"c, p"
"3-oxo-hexacosenoyl-CoA"	"3-oxo-hexacosenoyl-CoA"	"c, p"
"3(S)-hydroxy-hexacosenoyl-CoA"	"3(S)-hydroxy-hexacosenoyl-CoA"	"c, p"
"trans,cis-2,17-hexacosadienoyl-CoA"	"trans,cis-2,17-hexacosadienoyl-CoA"	"c, p"
"3-oxo-13-cis-eicosenoyl-CoA"	"3-oxo-13-cis-eicosenoyl-CoA"	"c, m, p"
"3(S)-hydroxy-13-cis-eicosenoyl-CoA"	"3(S)-hydroxy-13-cis-eicosenoyl-CoA"	"c, m, p"
"trans,cis-2,13-eicosadienoyl-CoA"	"trans,cis-2,13-eicosadienoyl-CoA"	"c, m, p"
"(7Z)-octadecenoyl-CoA"	"(7Z)-octadecenoyl-CoA"	"c, m, r"
"3-oxo-9-cis-eicosenoyl-CoA"	"3-oxo-9-cis-eicosenoyl-CoA"	"c"
"3(S)-hydroxy-9-cis-eicosenoyl-CoA"	"3(S)-hydroxy-9-cis-eicosenoyl-CoA"	"c"
"trans,cis-2,9-eicosadienoyl-CoA"	"trans,cis-2,9-eicosadienoyl-CoA"	"c"
"3-oxo-11cis-docosenoyl-CoA"	"3-oxo-11cis-docosenoyl-CoA"	"c"
"3(S)-hydroxy-11-cis-docosenoyl-CoA"	"3(S)-hydroxy-11-cis-docosenoyl-CoA"	"c"
"trans,cis-2,11-docosadienoyl-CoA"	"trans,cis-2,11-docosadienoyl-CoA"	"c"
"3-oxo-eicosadienoyl-CoA"	"3-oxo-eicosadienoyl-CoA"	"c"
"3(S)-hydroxy-3-oxo-eicosadienoyl-CoA"	"3(S)-hydroxy-3-oxo-eicosadienoyl-CoA"	"c"
"trans,cis-2,8,11-eicosatrienoyl-CoA"	"trans,cis-2,8,11-eicosatrienoyl-CoA"	"c"
"3-oxooctadecanoyl-CoA"	"3-oxooctadecanoyl-CoA"	"c, p, m"
"3-hydroxyoctadecanoyl-CoA"	"3-hydroxyoctadecanoyl-CoA"	"c, p, m"
"(2E)-octadecenoyl-CoA"	"(2E)-octadecenoyl-CoA"	"c, p, m"
"3-oxoeicosanoyl-CoA"	"3-oxoeicosanoyl-CoA"	"c, p, m"
"3-hydroxyeicosanoyl-CoA"	"3-hydroxyeicosanoyl-CoA"	"c, p, m"
"(2E)-eicosenoyl-CoA"	"(2E)-eicosenoyl-CoA"	"c, p, m"
"3-oxodocosanoyl-CoA"	"3-oxodocosanoyl-CoA"	"c, p, m"
"3-hydroxydocosanoyl-CoA"	"3-hydroxydocosanoyl-CoA"	"c, p, m"
"(2E)-docosenoyl-CoA"	"(2E)-docosenoyl-CoA"	"c, p, m"
"3-oxotetracosanoyl-CoA"	"3-oxotetracosanoyl-CoA"	"c, p"
"3-hydroxytetracosanoyl-CoA"	"3-hydroxytetracosanoyl-CoA"	"c, p"
"(2E)-tetracosenoyl-CoA"	"(2E)-tetracosenoyl-CoA"	"c, p"
"3-oxohexacosanoyl-CoA"	"3-oxohexacosanoyl-CoA"	"c, p"
"3-hydroxyhexacosanoyl-CoA"	"3-hydroxyhexacosanoyl-CoA"	"c, p"
"(2E)-hexacosenoyl-CoA"	"(2E)-hexacosenoyl-CoA"	"c, p"
"3-oxononadecanoyl-CoA"	"3-oxononadecanoyl-CoA"	"c, m"
"3-hydroxynonadecanoyl-CoA"	"3-hydroxynonadecanoyl-CoA"	"c, m"
"(2E)-nonadecenoyl-CoA"	"(2E)-nonadecenoyl-CoA"	"c, m"
"3-oxoheneicosanoyl-CoA"	"3-oxoheneicosanoyl-CoA"	"c, m"
"3-hydroxyheneicosanoyl-CoA"	"3-hydroxyheneicosanoyl-CoA"	"c, m"
"(2E)-heneicosenoyl-CoA"	"(2E)-heneicosenoyl-CoA"	"c, m"
"3-oxotricosanoyl-CoA"	"3-oxotricosanoyl-CoA"	"c"
"3-hydroxytricosanoyl-CoA"	"3-hydroxytricosanoyl-CoA"	"c"
"(2E)-tricosenoyl-CoA"	"(2E)-tricosenoyl-CoA"	"c"
"9(S)-HPODE"	"9(S)-HPODE"	"c"
"9-hydroxyoctadecadienoate"	"9-hydroxyoctadecadienoate"	"c"
"13(S)-HPODE"	"13(S)-HPODE"	"c"
"13(S)-HODE"	"13(S)-HODE"	"c"
"9(10)-EpOME"	"9(10)-EpOME"	"c, r"
"12(13)-EpOME"	"12(13)-EpOME"	"c, r"
"9,10-hydroxyoctadec-12(Z)-enoate"	"9,10-hydroxyoctadec-12(Z)-enoate"	"c, r"
"12,13-hydroxyoctadec-9(z)-enoate"	"12,13-hydroxyoctadec-9(z)-enoate"	"c, r"
"lipoicacid"	"lipoicacid"	"c, e"
"lipoyl-AMP"	"lipoyl-AMP"	"c"
"[protein]-N6-(lipoyl)lysine"	"[protein]-N6-(lipoyl)lysine"	"c"
"5-deoxyadenosine"	"5-deoxyadenosine"	"c"
"lipoyl-[ACP]"	"lipoyl-[ACP]"	"c"
"[protein]-N6-(octanoyl)lysine"	"[protein]-N6-(octanoyl)lysine"	"c"
"[protein]-N6-(dihydrolipoyl)lysine"	"[protein]-N6-(dihydrolipoyl)lysine"	"c"
"3-keto-eicosa-8,11,14,17-all-cis-tetraenoyl-CoA"	"3-keto-eicosa-8,11,14,17-all-cis-tetraenoyl-CoA"	"c"
"3(S)-hydroxy-all-cis-8,11,14,17-eicosatetraenoyl-CoA"	"3(S)-hydroxy-all-cis-8,11,14,17-eicosatetraenoyl-CoA"	"c"
"eicosa-(2E,8Z,11Z,14Z,17Z)-pentaenoyl-CoA"	"eicosa-(2E,8Z,11Z,14Z,17Z)-pentaenoyl-CoA"	"c"
"3-oxo-docosa-7,10,13,16,19-all-cis-pentaenoyl-CoA"	"3-oxo-docosa-7,10,13,16,19-all-cis-pentaenoyl-CoA"	"c"
"3(S)-hydroxy-docosa-7,10,13,16,19-all-cis-pentaenoyl-CoA"	"3(S)-hydroxy-docosa-7,10,13,16,19-all-cis-pentaenoyl-CoA"	"c"
"2-trans-7,10,13,16,19-all-cis-docosahexaenoyl-CoA"	"2-trans-7,10,13,16,19-all-cis-docosahexaenoyl-CoA"	"c"
"3-oxo-tetracosa-9,12,15,18,21-all-cis-pentaenoyl-CoA"	"3-oxo-tetracosa-9,12,15,18,21-all-cis-pentaenoyl-CoA"	"c"
"3(S)-hydroxy-tetracosa-9,12,15,18,21-all-cis-pentaenoyl-CoA"	"3(S)-hydroxy-tetracosa-9,12,15,18,21-all-cis-pentaenoyl-CoA"	"c"
"2-trans-9,12,15,18,21-all-cis-tetracosahexaenoyl-CoA"	"2-trans-9,12,15,18,21-all-cis-tetracosahexaenoyl-CoA"	"c"
"delta2-THA-CoA"	"delta2-THA-CoA"	"p"
"3-hydroxy-THA-CoA"	"3-hydroxy-THA-CoA"	"p"
"3-keto-THA-CoA"	"3-keto-THA-CoA"	"p"
"3-oxo-docosa-10,13,16,19-all-cis-tetraenoyl-CoA"	"3-oxo-docosa-10,13,16,19-all-cis-tetraenoyl-CoA"	"c"
"3(S)-hydroxy-docosa-10,13,16,19-all-cis-tetraenoyl-CoA"	"3(S)-hydroxy-docosa-10,13,16,19-all-cis-tetraenoyl-CoA"	"c"
"trans,cis,cis,cis,cis-2,10,13,16,19-docosapentaenoyl-CoA"	"trans,cis,cis,cis,cis-2,10,13,16,19-docosapentaenoyl-CoA"	"c"
"3-oxo-tetracosa-12,15,18,21-all-cis-tetraenoyl-CoA"	"3-oxo-tetracosa-12,15,18,21-all-cis-tetraenoyl-CoA"	"c"
"3(S)-hydroxy-tetracosa-12,15,18,21-all-cis-tetraenoyl-CoA"	"3(S)-hydroxy-tetracosa-12,15,18,21-all-cis-tetraenoyl-CoA"	"c"
"trans,cis,cis,cis,cis-2,12,15,18,21-tetracosapentaenoyl-CoA"	"trans,cis,cis,cis,cis-2,12,15,18,21-tetracosapentaenoyl-CoA"	"c"
"3-oxoeicosa-cis,cis,cis-11,14,17-trienoyl-CoA"	"3-oxoeicosa-cis,cis,cis-11,14,17-trienoyl-CoA"	"c"
"(3S)-hydroxy-eicosa-cis,cis,cis-11,14,17-trienoyl-CoA"	"(3S)-hydroxy-eicosa-cis,cis,cis-11,14,17-trienoyl-CoA"	"c"
"trans,cis,cis,cis-2,11,14,17-eicosatetraenoyl-CoA"	"trans,cis,cis,cis-2,11,14,17-eicosatetraenoyl-CoA"	"c"
"3-oxo-docosa-13,16,19-all-cis-trienoyl-CoA"	"3-oxo-docosa-13,16,19-all-cis-trienoyl-CoA"	"c"
"3(S)-hydroxy-docosa-13,16,19-all-cis-trienoyl-CoA"	"3(S)-hydroxy-docosa-13,16,19-all-cis-trienoyl-CoA"	"c"
"trans,cis,cis,cis-2,13,16,19-docosatetraenoyl-CoA"	"trans,cis,cis,cis-2,13,16,19-docosatetraenoyl-CoA"	"c"
"5(S)-HpEPE"	"5(S)-HpEPE"	"c, n"
"5(S)-HEPE"	"5(S)-HEPE"	"c, p"
"5-oxo-EPE"	"5-oxo-EPE"	"c, p"
"leukotrieneA5"	"leukotrieneA5"	"c"
"leukotrieneB5"	"leukotrieneB5"	"c"
"leukotrieneC5"	"leukotrieneC5"	"c"
"leukotrieneD5"	"leukotrieneD5"	"c"
"15(R)-HpEPE"	"15(R)-HpEPE"	"c, n, r, p"
"15(R)-HEPE"	"15(R)-HEPE"	"c, n, r, p"
"5(S),6(S)-epoxy-15(R)-HEPE"	"5(S),6(S)-epoxy-15(R)-HEPE"	"c, n, r, p"
"15-epi-lipoxinB5"	"15-epi-lipoxinB5"	"c, r, p"
"15-epi-lipoxinA5"	"15-epi-lipoxinA5"	"c, r, p"
"PGH3"	"PGH3"	"c, n"
"prostaglandinE3"	"prostaglandinE3"	"c, n"
"(18R)-HEPE"	"(18R)-HEPE"	"c"
"5,6-epoxy,(18R)-HEPE"	"5,6-epoxy,(18R)-HEPE"	"c"
"(18R)-hydroxy-(5Z,8Z,11Z,14Z,16E)-eicosapentaenoicacid"	"(18R)-hydroxy-(5Z,8Z,11Z,14Z,16E)-eicosapentaenoicacid"	"c"
"3-oxo-dihomo-gamma-linolenoyl-CoA"	"3-oxo-dihomo-gamma-linolenoyl-CoA"	"c, m, p"
"trans-2-cis,cis,cis-8,11,14-eicosatetraenoyl-CoA"	"trans-2-cis,cis,cis-8,11,14-eicosatetraenoyl-CoA"	"c, m, p"
"3-oxo-docosa-7,10,13,16-all-cis-tetraenoyl-CoA"	"3-oxo-docosa-7,10,13,16-all-cis-tetraenoyl-CoA"	"c"
"3(S)-hydroxy-docosa-7,10,13,16-all-cis-tetraenoyl-CoA"	"3(S)-hydroxy-docosa-7,10,13,16-all-cis-tetraenoyl-CoA"	"c"
"(2E,7Z,10Z,13Z,16Z)-docosapentaenoyl-CoA"	"(2E,7Z,10Z,13Z,16Z)-docosapentaenoyl-CoA"	"c"
"3-oxo-tetracosa-9,12,15,18-all-cis-tetraenoyl-CoA"	"3-oxo-tetracosa-9,12,15,18-all-cis-tetraenoyl-CoA"	"c"
"2-trans-9,12,15,18-all-cis-tetracosapentaenoyl-CoA"	"2-trans-9,12,15,18-all-cis-tetracosapentaenoyl-CoA"	"c"
"trans-2-all-cis-6,9,12,15,18-tetracosahexaenoyl-CoA"	"trans-2-all-cis-6,9,12,15,18-tetracosahexaenoyl-CoA"	"p"
"3(S)-hydroxy-tetracosa-6,9,12,15,18-all-cis-pentaenoyl-CoA"	"3(S)-hydroxy-tetracosa-6,9,12,15,18-all-cis-pentaenoyl-CoA"	"p"
"3-oxo-all-cis-6,9,12,15,18-tetracosapentaenoyl-CoA"	"3-oxo-all-cis-6,9,12,15,18-tetracosapentaenoyl-CoA"	"p"
"3-oxo-docosa-cis,cis,cis-10,13,16-trienoyl-CoA"	"3-oxo-docosa-cis,cis,cis-10,13,16-trienoyl-CoA"	"c"
"3(S)-hydroxy-10,13,16-all-cis-docosatrienoyl-CoA"	"3(S)-hydroxy-10,13,16-all-cis-docosatrienoyl-CoA"	"c"
"trans,cis,cis,cis-2,10,13,16-docosatetraenoyl-CoA"	"trans,cis,cis,cis-2,10,13,16-docosatetraenoyl-CoA"	"c"
"3-oxoeicosa-cis,cis-11,14-dienoyl-CoA"	"3-oxoeicosa-cis,cis-11,14-dienoyl-CoA"	"c"
"(3S)-hydroxy-eicosa-cis,cis-11,14-dienoyl-CoA"	"(3S)-hydroxy-eicosa-cis,cis-11,14-dienoyl-CoA"	"c"
"trans,cis,cis-2,11,14-eicosatrienoyl-CoA"	"trans,cis,cis-2,11,14-eicosatrienoyl-CoA"	"c"
"3-oxodocasa-cis,cis-13,16-dienoyl-CoA"	"3-oxodocasa-cis,cis-13,16-dienoyl-CoA"	"c"
"(3S)-hydroxy-docasa-cis,cis-13,16-dienoyl-CoA"	"(3S)-hydroxy-docasa-cis,cis-13,16-dienoyl-CoA"	"c"
"trans,cis,cis-2,13,16-docasatrienoyl-CoA"	"trans,cis,cis-2,13,16-docasatrienoyl-CoA"	"c"
"2-trans-cis,cis,cis,cis-4,8,11,14-eicosapentaenoyl-CoA"	"2-trans-cis,cis,cis,cis-4,8,11,14-eicosapentaenoyl-CoA"	"m, p"
"trans-3-cis-5,8,11,14-eicosapentaenoyl-CoA"	"trans-3-cis-5,8,11,14-eicosapentaenoyl-CoA"	"m, p"
"trans-3-cis-8,11,14-eicosatetraenoyl-CoA"	"trans-3-cis-8,11,14-eicosatetraenoyl-CoA"	"m, p"
"3(S)-hydroxy-dihomo-gamma-linolenoyl-CoA"	"3(S)-hydroxy-dihomo-gamma-linolenoyl-CoA"	"m, p"
"(2E,6Z,9Z,12Z)-octadecatetraenoyl-CoA"	"(2E,6Z,9Z,12Z)-octadecatetraenoyl-CoA"	"m, p"
"3(S)-hydroxy-(6Z,9Z,12Z)-octadecatrienoyl-CoA"	"3(S)-hydroxy-(6Z,9Z,12Z)-octadecatrienoyl-CoA"	"m, p"
"3-oxo-(6Z,9Z,12Z)-octadecatrienoyl-CoA"	"3-oxo-(6Z,9Z,12Z)-octadecatrienoyl-CoA"	"m, p"
"(4Z,7Z,10Z)-hexadecatrienoyl-CoA"	"(4Z,7Z,10Z)-hexadecatrienoyl-CoA"	"m, p"
"(2E,4Z,7Z,10Z)-hexadecatetraenoyl-CoA"	"(2E,4Z,7Z,10Z)-hexadecatetraenoyl-CoA"	"m, p"
"(3Z,7Z,10Z)-hexadecatrienoyl-CoA"	"(3Z,7Z,10Z)-hexadecatrienoyl-CoA"	"m, p"
"trans,cis,cis-2,7,10-hexadecatrienoyl-CoA"	"trans,cis,cis-2,7,10-hexadecatrienoyl-CoA"	"m, p"
"7-HETE"	"7-HETE"	"c"
"8-HETE"	"8-HETE"	"c"
"9-HETE"	"9-HETE"	"c"
"10-HETE"	"10-HETE"	"c"
"11-HETE"	"11-HETE"	"c"
"13-HETE"	"13-HETE"	"c"
"16(R)-HETE"	"16(R)-HETE"	"c"
"17-HETE"	"17-HETE"	"c"
"18-HETE"	"18-HETE"	"c"
"19(S)-HETE"	"19(S)-HETE"	"c"
"5,6-EET"	"5,6-EET"	"c, r"
"5,6-DHET"	"5,6-DHET"	"c"
"8,9-EET"	"8,9-EET"	"c, r"
"8,9-DHET"	"8,9-DHET"	"c"
"11,12-EET"	"11,12-EET"	"c"
"11,12-DHET"	"11,12-DHET"	"c"
"14,15-EET"	"14,15-EET"	"c, r"
"14,15-DHET"	"14,15-DHET"	"c"
"5(S)-HPETE"	"5(S)-HPETE"	"c, m"
"leukotrieneA4"	"leukotrieneA4"	"c, n"
"5(S)-HETE"	"5(S)-HETE"	"c, m, r"
"leukotrieneB4"	"leukotrieneB4"	"c, m, r, p"
"5,15-DiHETE"	"5,15-DiHETE"	"c"
"5-oxo-ETE"	"5-oxo-ETE"	"c"
"5-oxo-12-HETE"	"5-oxo-12-HETE"	"c"
"5,12-DiHETE"	"5,12-DiHETE"	"c"
"15(S)-HETE"	"15(S)-HETE"	"c"
"15(S)-HPETE"	"15(S)-HPETE"	"c, n, r, p"
"15H-11,12-EETA"	"15H-11,12-EETA"	"c"
"11,12,15-THETA"	"11,12,15-THETA"	"c"
"11h-14,15-EETA"	"11h-14,15-EETA"	"c"
"11,14,15-THETA"	"11,14,15-THETA"	"c"
"15(R)-HETE"	"15(R)-HETE"	"c, p, r"
"(5S,6S)-epoxy-(15R)-hydroxy-ETE"	"(5S,6S)-epoxy-(15R)-hydroxy-ETE"	"c, p, r"
"15-epi-lipoxinA4"	"15-epi-lipoxinA4"	"c, p, r"
"15-epi-lipoxinB4"	"15-epi-lipoxinB4"	"c, p, r"
"14,15-DiHETE"	"14,15-DiHETE"	"c, n"
"lipoxinB4"	"lipoxinB4"	"c, n, r, p"
"5,6-epoxytetraene"	"5,6-epoxytetraene"	"c, n, r, p"
"lipoxinA4"	"lipoxinA4"	"c, n, r, p"
"12(S)-HPETE"	"12(S)-HPETE"	"c, e, r, p"
"12(S)-HETE"	"12(S)-HETE"	"c, r"
"hepoxilinA3"	"hepoxilinA3"	"c, e, p, r"
"hepoxilinA3-c"	"hepoxilinA3-c"	"c, r, p"
"trioxilinA3"	"trioxilinA3"	"c, r, p"
"8(S)-HPETE"	"8(S)-HPETE"	"c"
"8(S)-HETE"	"8(S)-HETE"	"c"
"(11R)-HPETE"	"(11R)-HPETE"	"c"
"9,10-epoxy-(6Z,12Z)-octadecadienoicacid"	"9,10-epoxy-(6Z,12Z)-octadecadienoicacid"	"c"
"7,8-epoxy-(4Z,10Z)-hexadecadienoicacid"	"7,8-epoxy-(4Z,10Z)-hexadecadienoicacid"	"c"
"5,6-epoxy-(8Z)-tetradecenoicacid"	"5,6-epoxy-(8Z)-tetradecenoicacid"	"c"
"12,13-epoxy-(6Z,9Z)-octadecadienoicacid"	"12,13-epoxy-(6Z,9Z)-octadecadienoicacid"	"c"
"10,11-epoxy-(4Z,7Z)-hexadecadienoicacid"	"10,11-epoxy-(4Z,7Z)-hexadecadienoicacid"	"c"
"8,9-epoxy-(5Z)-tetradecenoicacid"	"8,9-epoxy-(5Z)-tetradecenoicacid"	"c"
"11,12-dihydroxy-(5E,7E,9E,14Z)-eicosatetraenoate"	"11,12-dihydroxy-(5E,7E,9E,14Z)-eicosatetraenoate"	"c"
"12-hetre"	"12-hetre"	"c"
"noladin-ether"	"noladin-ether"	"c"
"leukotrieneC4"	"leukotrieneC4"	"e, c, r"
"5-L-gamma-glutamyl"	"5-L-gamma-glutamyl"	"e"
"LTD4"	"LTD4"	"e, c, r"
"leukotrieneE4"	"leukotrieneE4"	"e, c, n"
"N-acetyl-LTE4"	"N-acetyl-LTE4"	"c, n"
"13,14-dihydro-15-oxo-lipoxinA4"	"13,14-dihydro-15-oxo-lipoxinA4"	"c"
"15-oxo-lipoxinA4"	"15-oxo-lipoxinA4"	"c"
"12-keto-LTB4"	"12-keto-LTB4"	"c, m, r, p"
"12-oxo-10,11-dihydro-20-COOH-LTB4"	"12-oxo-10,11-dihydro-20-COOH-LTB4"	"c, r"
"12-oxo-20-carboxy-LTB4"	"12-oxo-20-carboxy-LTB4"	"c, r"
"12-oxo-c-LTB3"	"12-oxo-c-LTB3"	"c, m, r, p"
"10,11-dihydro-12R-hydroxy-LTC4"	"10,11-dihydro-12R-hydroxy-LTC4"	"c, m, p"
"20-OH-LTB4"	"20-OH-LTB4"	"c, m, r"
"20-oxo-LTB4"	"20-oxo-LTB4"	"c, m, r"
"20-COOH-LTB4"	"20-COOH-LTB4"	"c, m, r, p"
"5-oxo-6-trans-LTB4"	"5-oxo-6-trans-LTB4"	"c, m, p, r"
"6-trans-LTB4"	"6-trans-LTB4"	"c, m, p"
"6,7-dihydro-5-oxo-LTB4"	"6,7-dihydro-5-oxo-LTB4"	"c, m, r, p"
"6,7-dihydro-LTB4"	"6,7-dihydro-LTB4"	"c, m, r, p"
"5-oxo-12(R)-hydroxy-eicosa-(8E,10E,14Z)-trienoyl-CoA"	"5-oxo-12(R)-hydroxy-eicosa-(8E,10E,14Z)-trienoyl-CoA"	"c, m, r, p"
"5-oxo-12(R)-hydroxy-eicosa-(2E,8E,10E,14Z)-tetraenoyl-CoA"	"5-oxo-12(R)-hydroxy-eicosa-(2E,8E,10E,14Z)-tetraenoyl-CoA"	"m, p"
"3(S),12(R)-dihydroxy-5-oxo-eicosa-(8E,10E,14Z)-trienoyl-CoA"	"3(S),12(R)-dihydroxy-5-oxo-eicosa-(8E,10E,14Z)-trienoyl-CoA"	"m, p"
"3,5-dioxo-12(R)-hydroxy-eicosa-(8E,10E,14Z)-trienoyl-CoA"	"3,5-dioxo-12(R)-hydroxy-eicosa-(8E,10E,14Z)-trienoyl-CoA"	"m, p"
"3-oxo-10(R)-hydroxy-octadeca-(6E,8E,12Z)-trienoyl-CoA"	"3-oxo-10(R)-hydroxy-octadeca-(6E,8E,12Z)-trienoyl-CoA"	"m, p"
"3-oxo-10(R)-hydroxy-octadeca-(6E,8E,12Z)-trienoate"	"3-oxo-10(R)-hydroxy-octadeca-(6E,8E,12Z)-trienoate"	"m, p"
"5-oxo-(6E)-12-epi-LTB4"	"5-oxo-(6E)-12-epi-LTB4"	"c, m, p, r"
"6-trans-12-epi-LTB4"	"6-trans-12-epi-LTB4"	"c, m, p"
"6,7-dihydro-5-oxo-12-epi-LTB4"	"6,7-dihydro-5-oxo-12-epi-LTB4"	"c, m, r, p"
"5-oxo-12(S)-hydroxy-eicosa-(8E,10E,14Z)-trienoyl-CoA"	"5-oxo-12(S)-hydroxy-eicosa-(8E,10E,14Z)-trienoyl-CoA"	"c, m, r, p"
"5-oxo-12(S)-hydroxy-eicosa-(2E,8E,10E,14Z)-tetraenoyl-CoA"	"5-oxo-12(S)-hydroxy-eicosa-(2E,8E,10E,14Z)-tetraenoyl-CoA"	"m, p"
"3(S),12(S)-dihydroxy-5-oxo-eicosa-(8E,10E,14Z)-trienoyl-CoA"	"3(S),12(S)-dihydroxy-5-oxo-eicosa-(8E,10E,14Z)-trienoyl-CoA"	"m, p"
"3,5-dioxo-12(S)-hydroxy-eicosa-(8E,10E,14Z)-trienoyl-CoA"	"3,5-dioxo-12(S)-hydroxy-eicosa-(8E,10E,14Z)-trienoyl-CoA"	"m, p"
"3-oxo-10(S)-hydroxy-octadeca-(6E,8E,12Z)-trienoyl-CoA"	"3-oxo-10(S)-hydroxy-octadeca-(6E,8E,12Z)-trienoyl-CoA"	"m, p"
"3-oxo-10(S)-hydroxy-octadeca-(6E,8E,12Z)-trienoate"	"3-oxo-10(S)-hydroxy-octadeca-(6E,8E,12Z)-trienoate"	"m, p"
"10,11-dihydro-12-oxo-LTB4"	"10,11-dihydro-12-oxo-LTB4"	"c, m, p"
"10,11-dihydro-LTB4"	"10,11-dihydro-LTB4"	"c, m, p, r"
"20-COOH-10,11-dihydro-LTB4"	"20-COOH-10,11-dihydro-LTB4"	"c, m, p"
"20-CoA-20-oxo-LTB4"	"20-CoA-20-oxo-LTB4"	"c, m, r, p"
"(18E)-20-oxo-20-CoA-LTB4"	"(18E)-20-oxo-20-CoA-LTB4"	"m, p"
"20-CoA-20-oxo-18r-hydroxy-LTB4"	"20-CoA-20-oxo-18r-hydroxy-LTB4"	"m, p"
"18,20-dioxo-20-CoA-LTB4"	"18,20-dioxo-20-CoA-LTB4"	"m, p"
"18-CoA-18-oxo-dinor-LTB4"	"18-CoA-18-oxo-dinor-LTB4"	"m, p"
"omega-carboxy-trinor-LTB4"	"omega-carboxy-trinor-LTB4"	"m, p"
"10,11-dihydro-LTB4-CoA"	"10,11-dihydro-LTB4-CoA"	"c, m, r, p"
"5(S),12(R)-dihydroxy-eicosa-2,8-trans-6,14-cis-tetraenoyl-CoA"	"5(S),12(R)-dihydroxy-eicosa-2,8-trans-6,14-cis-tetraenoyl-CoA"	"m, p"
"3(S),5(S),12(R)-trihydroxy-eicosa-8-trans-6,14-cis-trienoyl-CoA"	"3(S),5(S),12(R)-trihydroxy-eicosa-8-trans-6,14-cis-trienoyl-CoA"	"m, p"
"3-oxo-5(S),12(R)-dihydroxy-eicosa-8-trans-6,14-cis-trienoyl-CoA"	"3-oxo-5(S),12(R)-dihydroxy-eicosa-8-trans-6,14-cis-trienoyl-CoA"	"m, p"
"3(S),10(R)-OH-octadeca-6-trans-4,12-cis-trienoyl-CoA"	"3(S),10(R)-OH-octadeca-6-trans-4,12-cis-trienoyl-CoA"	"m, p"
"3(S),10(R)-OH-octadeca-6-trans-4,12-cis-trienoate"	"3(S),10(R)-OH-octadeca-6-trans-4,12-cis-trienoate"	"m, p"
"10,11-dihydro-12-epi-LTB4"	"10,11-dihydro-12-epi-LTB4"	"c, m, p"
"20-hydroxy-LTE4"	"20-hydroxy-LTE4"	"p"
"20-oxo-LTE4"	"20-oxo-LTE4"	"p"
"20-COOH-LTE4"	"20-COOH-LTE4"	"p"
"20-COOH-LTE4-CoA"	"20-COOH-LTE4-CoA"	"p"
"(18E)-20-oxo-20-CoA-LTE4"	"(18E)-20-oxo-20-CoA-LTE4"	"p"
"18(R)-hydroxy-20-oxo-20-CoA-LTE4"	"18(R)-hydroxy-20-oxo-20-CoA-LTE4"	"p"
"20-COOH-18-oxo-LTE4-CoA"	"20-COOH-18-oxo-LTE4-CoA"	"p"
"omega-COOH-dinor-LTE4-CoA"	"omega-COOH-dinor-LTE4-CoA"	"p"
"18-COOH-LTE4"	"18-COOH-LTE4"	"p"
"18-COOH-(16E)-dinor-LTE5-CoA"	"18-COOH-(16E)-dinor-LTE5-CoA"	"p"
"18-COOH-(15E)-dinor-LTE4-CoA"	"18-COOH-(15E)-dinor-LTE4-CoA"	"p"
"16e-18-oxo-18-CoA-dinor-LTE4"	"16e-18-oxo-18-CoA-dinor-LTE4"	"p"
"16(S)-hydroxy-18-oxo-18-CoA-LTE4"	"16(S)-hydroxy-18-oxo-18-CoA-LTE4"	"p"
"16,18-oxo-18-CoA-dinor-LTE4"	"16,18-oxo-18-CoA-dinor-LTE4"	"p"
"omega-COOH-tetranor-LTE3-CoA"	"omega-COOH-tetranor-LTE3-CoA"	"p"
"omega-COOH-tetranor-LTE3"	"omega-COOH-tetranor-LTE3"	"p"
"(13E)-tetranor-16-oxo-16-CoA-LTE4"	"(13E)-tetranor-16-oxo-16-CoA-LTE4"	"p"
"(13E)-tetranor-16-carboxy-LTE4"	"(13E)-tetranor-16-carboxy-LTE4"	"p"
"(13E)-11alpha-hydroxy-9,15-dioxoprost-13-enoate"	"(13E)-11alpha-hydroxy-9,15-dioxoprost-13-enoate"	"c"
"prostaglandinE1"	"prostaglandinE1"	"c, e"
"prostaglandinH2"	"prostaglandinH2"	"c, r"
"prostaglandinD2"	"prostaglandinD2"	"r, c"
"prostaglandinE2"	"prostaglandinE2"	"r, c, e"
"O-butanoylcarnitine"	"O-butanoylcarnitine"	"c, m"
"O-acetylcarnitine"	"O-acetylcarnitine"	"c, m, p, r"
"O-propanoylcarnitine"	"O-propanoylcarnitine"	"c, m, p"
"malonyl-carnitin"	"malonyl-carnitin"	"c, m, p, r"
"dodecanoylcarnitine"	"dodecanoylcarnitine"	"c, m, r"
"tridecanoylcarnitine"	"tridecanoylcarnitine"	"c, m, r"
"tetradecanoylcarnitine"	"tetradecanoylcarnitine"	"c, m, r"
"tetradecenoylcarnitine(5)"	"tetradecenoylcarnitine(5)"	"c, m, r"
"tetradecenoylcarnitine(7)"	"tetradecenoylcarnitine(7)"	"c, m, r"
"tetradecenoylcarnitine(9)"	"tetradecenoylcarnitine(9)"	"c, m, r"
"pentadecanoylcarnitine"	"pentadecanoylcarnitine"	"c, m, r"
"L-palmitoylcarnitine"	"L-palmitoylcarnitine"	"c, m, r"
"hexadecenoylcarnitine(9)"	"hexadecenoylcarnitine(9)"	"c, m, r"
"palmitoleoyl-carnitine"	"palmitoleoyl-carnitine"	"c, m, r"
"heptadecanoylcarnitine"	"heptadecanoylcarnitine"	"c, m, r"
"heptadecenoylcarnitine(7)"	"heptadecenoylcarnitine(7)"	"c, m, r"
"heptadecenoylcarnitine(8)"	"heptadecenoylcarnitine(8)"	"c, m, r"
"stearoylcarnitine"	"stearoylcarnitine"	"c, m, r"
"octadecenoylcarnitine(5)"	"octadecenoylcarnitine(5)"	"c, m, r"
"octadecenoylcarnitine(7)"	"octadecenoylcarnitine(7)"	"c, m, r"
"L-oleoylcarnitine"	"L-oleoylcarnitine"	"c, m, r"
"(9E)-octadecenoylcarnitine"	"(9E)-octadecenoylcarnitine"	"c, m, r"
"octadecenoylcarnitine(11)"	"octadecenoylcarnitine(11)"	"c, m, r"
"(6Z,9Z)-octadecadienoylcarnitine"	"(6Z,9Z)-octadecadienoylcarnitine"	"c, m, r"
"nonadecanoylcarnitine"	"nonadecanoylcarnitine"	"c, m, r"
"eicosanoylcarnitine"	"eicosanoylcarnitine"	"c, m, r"
"eicosenoylcarnitine(7)"	"eicosenoylcarnitine(7)"	"c, m, r"
"eicosenoylcarnitine(9)"	"eicosenoylcarnitine(9)"	"c, m, r"
"eicosenoylcarnitine(11)"	"eicosenoylcarnitine(11)"	"c, m, r"
"(8Z,11Z)-eicosadienoylcarnitine"	"(8Z,11Z)-eicosadienoylcarnitine"	"c, m, r"
"(5Z,8Z,11Z)-eicosatrienoylcarnitine"	"(5Z,8Z,11Z)-eicosatrienoylcarnitine"	"c, m, r"
"heneicosanoylcarnitine"	"heneicosanoylcarnitine"	"c, m, r"
"docosanoylcarnitine"	"docosanoylcarnitine"	"c, m, r"
"docosenoylcarnitine"	"docosenoylcarnitine"	"c, m, r"
"docosenoylcarnitine(11)"	"docosenoylcarnitine(11)"	"c, m, r"
"octadecatrienoylcarnitine"	"octadecatrienoylcarnitine"	"c, m, r"
"(6Z,9Z,12Z,15Z)-octadecatetraenoylcarnitine"	"(6Z,9Z,12Z,15Z)-octadecatetraenoylcarnitine"	"c, m, r"
"(8Z,11Z,14Z,17Z)-eicosatetraenoylcarnitine"	"(8Z,11Z,14Z,17Z)-eicosatetraenoylcarnitine"	"c, m, r"
"(5Z,8Z,11Z,14Z,17Z)-eicosapentaenoylcarnitine"	"(5Z,8Z,11Z,14Z,17Z)-eicosapentaenoylcarnitine"	"c, m, r"
"(7Z,10Z,13Z,16Z,19Z)-docosapentaenoylcarnitine"	"(7Z,10Z,13Z,16Z,19Z)-docosapentaenoylcarnitine"	"c, m, r"
"docosahexaenoylcarnitine"	"docosahexaenoylcarnitine"	"c, m, r"
"(11Z,14Z,17Z)-eicosatrienoylcarnitine"	"(11Z,14Z,17Z)-eicosatrienoylcarnitine"	"c, m, r"
"13,16,19-docosatrienoylcarnitine"	"13,16,19-docosatrienoylcarnitine"	"c, m, r"
"10,13,16,19-docosatetraenoylcarnitine"	"10,13,16,19-docosatetraenoylcarnitine"	"c, m, r"
"linoleic-carnitine"	"linoleic-carnitine"	"c, m, r"
"gamma-linolenoylcarnitine"	"gamma-linolenoylcarnitine"	"c, m, r"
"eicosatrienoylcarnitine"	"eicosatrienoylcarnitine"	"c, m, r"
"arachidonyl-carnitine"	"arachidonyl-carnitine"	"c, m, r"
"ocosatetraenoylcarnitine"	"ocosatetraenoylcarnitine"	"c, m, r"
"(4Z,7Z,10Z,13Z,16Z)-docosapentaenoylcarnitine"	"(4Z,7Z,10Z,13Z,16Z)-docosapentaenoylcarnitine"	"c, m, r"
"eicosadienoylcarnitine"	"eicosadienoylcarnitine"	"c, m, r"
"(13Z,16Z)-docosadienoylcarnitine"	"(13Z,16Z)-docosadienoylcarnitine"	"c, m, r"
"10,13,16-docosatrienoylcarnitine"	"10,13,16-docosatrienoylcarnitine"	"c, m, r"
"12,15,18,21-tetracosatetraenoylcarnitine"	"12,15,18,21-tetracosatetraenoylcarnitine"	"c, r"
"L-octanoylcarnitine"	"L-octanoylcarnitine"	"c, m, p"
"tricosanoylcarnitine"	"tricosanoylcarnitine"	"c, r"
"tetracosanoylcarnitine"	"tetracosanoylcarnitine"	"c, r"
"(15Z)-tetracosenoylcarnitine"	"(15Z)-tetracosenoylcarnitine"	"c, r"
"hexacosanoylcarnitine"	"hexacosanoylcarnitine"	"c, r"
"hexacosenoylcarnitine"	"hexacosenoylcarnitine"	"c, r"
"(9Z,12Z,15Z,18Z,21Z)-tetracosapentaenoylcarnitine"	"(9Z,12Z,15Z,18Z,21Z)-tetracosapentaenoylcarnitine"	"c, r"
"(9Z,12Z,15Z,18Z)-tetracosatetraenoylcarnitine"	"(9Z,12Z,15Z,18Z)-tetracosatetraenoylcarnitine"	"c, r"
"(6Z,9Z,12Z,15Z,18Z)-tetracosapentaenoylcarnitine"	"(6Z,9Z,12Z,15Z,18Z)-tetracosapentaenoylcarnitine"	"c, r"
"(6Z,9Z,12Z,15Z,18Z,21Z)-tetracosahexaenoylcarnitine"	"(6Z,9Z,12Z,15Z,18Z,21Z)-tetracosahexaenoylcarnitine"	"c, r"
"chylomicron"	"chylomicron"	"e"
"TAG-chylomicronpool"	"TAG-chylomicronpool"	"e"
"chylomicronremnant"	"chylomicronremnant"	"e, l"
"1,2-diacylglycerol-chylomicronpool"	"1,2-diacylglycerol-chylomicronpool"	"e"
"fattyacid-chylomicronpool"	"fattyacid-chylomicronpool"	"e"
"1-acylglycerol-chylomicronpool"	"1-acylglycerol-chylomicronpool"	"e, c"
"fattyacid-LD-TG1pool"	"fattyacid-LD-TG1pool"	"c, l"
"sn-glycerol-3-phosphate"	"sn-glycerol-3-phosphate"	"m, c, p"
"1,2-diacylglycerol-LD-TAGpool"	"1,2-diacylglycerol-LD-TAGpool"	"c, g, n"
"phosphatidate-LD-TAGpool"	"phosphatidate-LD-TAGpool"	"c, r"
"acyl-CoA-LD-TG3pool"	"acyl-CoA-LD-TG3pool"	"c"
"TAG-LDpool"	"TAG-LDpool"	"c, r"
"fattyacid-LD-TG3pool"	"fattyacid-LD-TG3pool"	"c"
"1-acylglycerol-LD-TG1pool"	"1-acylglycerol-LD-TG1pool"	"c"
"fattyacid-LD-TG2pool"	"fattyacid-LD-TG2pool"	"c"
"1,2-diacylglycerol-LD-PIpool"	"1,2-diacylglycerol-LD-PIpool"	"c"
"1-acylglycerol-LD-PIpool"	"1-acylglycerol-LD-PIpool"	"c"
"fattyacid-LD-PIpool"	"fattyacid-LD-PIpool"	"c"
"1,2-diacylglycerol-LD-PCpool"	"1,2-diacylglycerol-LD-PCpool"	"c"
"1-acylglycerol-LD-PCpool"	"1-acylglycerol-LD-PCpool"	"c"
"fattyacid-LD-PCpool"	"fattyacid-LD-PCpool"	"c, r, l"
"1,2-diacylglycerol-LD-PEpool"	"1,2-diacylglycerol-LD-PEpool"	"c, r"
"1-acylglycerol-LD-PEpool"	"1-acylglycerol-LD-PEpool"	"c"
"fattyacid-LD-PEpool"	"fattyacid-LD-PEpool"	"c"
"1,2-diacylglycerol-LD-PSpool"	"1,2-diacylglycerol-LD-PSpool"	"c"
"1-acylglycerol-LD-PSpool"	"1-acylglycerol-LD-PSpool"	"c"
"fattyacid-LD-PSpool"	"fattyacid-LD-PSpool"	"c"
"1,2-diacylglycerol-LD-SMpool"	"1,2-diacylglycerol-LD-SMpool"	"c"
"1-acylglycerol-LD-SMpool"	"1-acylglycerol-LD-SMpool"	"c"
"fattyacid-LD-SMpool"	"fattyacid-LD-SMpool"	"c"
"acyl-CoA-LD-TG2pool"	"acyl-CoA-LD-TG2pool"	"c"
"acylglycerone-phosphate"	"acylglycerone-phosphate"	"c, p"
"(2E)-hexadecenoyl-CoA"	"(2E)-hexadecenoyl-CoA"	"p, m"
"(S)-3-hydroxyhexadecanoyl-CoA"	"(S)-3-hydroxyhexadecanoyl-CoA"	"p, m"
"3-oxopalmitoyl-CoA"	"3-oxopalmitoyl-CoA"	"p, m"
"(2E)-tetradecenoyl-CoA"	"(2E)-tetradecenoyl-CoA"	"p, m"
"(S)-3-hydroxytetradecanoyl-CoA"	"(S)-3-hydroxytetradecanoyl-CoA"	"p, m"
"3-oxotetradecanoyl-CoA"	"3-oxotetradecanoyl-CoA"	"p, m"
"(2E)-dodecenoyl-CoA"	"(2E)-dodecenoyl-CoA"	"p, m"
"(S)-3-hydroxydodecanoyl-CoA"	"(S)-3-hydroxydodecanoyl-CoA"	"p, m"
"3-oxododecanoyl-CoA"	"3-oxododecanoyl-CoA"	"p, m"
"(2E)-decenoyl-CoA"	"(2E)-decenoyl-CoA"	"p, m"
"(S)-hydroxydecanoyl-CoA"	"(S)-hydroxydecanoyl-CoA"	"p, m"
"3-oxodecanoyl-CoA"	"3-oxodecanoyl-CoA"	"p, m"
"(2E)-octenoyl-CoA"	"(2E)-octenoyl-CoA"	"p, m"
"(S)-hydroxyoctanoyl-CoA"	"(S)-hydroxyoctanoyl-CoA"	"p, m"
"3-oxooctanoyl-CoA"	"3-oxooctanoyl-CoA"	"p, m"
"(2E)-hexenoyl-CoA"	"(2E)-hexenoyl-CoA"	"p, m"
"(S)-hydroxyhexanoyl-CoA"	"(S)-hydroxyhexanoyl-CoA"	"p, m"
"3-oxohexanoyl-CoA"	"3-oxohexanoyl-CoA"	"p, m"
"trans,cis-octadeca-2,9-dienoyl-CoA"	"trans,cis-octadeca-2,9-dienoyl-CoA"	"p, m"
"(S)-3-hydroxyoleyleoyl-CoA"	"(S)-3-hydroxyoleyleoyl-CoA"	"p, m"
"3-oxooleoyl-CoA"	"3-oxooleoyl-CoA"	"p, m"
"trans,cis-hexadeca-2,7-dienoyl-CoA"	"trans,cis-hexadeca-2,7-dienoyl-CoA"	"p, m"
"(S)-3-hydroxy-7-hexadecenoyl-CoA"	"(S)-3-hydroxy-7-hexadecenoyl-CoA"	"p, m"
"3-oxo-7-hexadecenoyl-CoA"	"3-oxo-7-hexadecenoyl-CoA"	"p, m"
"trans,cis-myristo-2,5-dienoyl-CoA"	"trans,cis-myristo-2,5-dienoyl-CoA"	"p, m"
"cis-(3S)-hydroxytetradec-5-enoyl-CoA"	"cis-(3S)-hydroxytetradec-5-enoyl-CoA"	"p, m"
"3-oxomyrist-5-enoyl-CoA"	"3-oxomyrist-5-enoyl-CoA"	"p, m"
"(3Z)-dodecenoyl-CoA"	"(3Z)-dodecenoyl-CoA"	"p, m"
"trans,cis-hexadeca-2,9-dienoyl-CoA"	"trans,cis-hexadeca-2,9-dienoyl-CoA"	"p, m"
"(S)-3-hydroxypalmitoleoyl-CoA"	"(S)-3-hydroxypalmitoleoyl-CoA"	"p, m"
"3-oxopalmitoleoyl-CoA"	"3-oxopalmitoleoyl-CoA"	"p, m"
"trans,cis-myristo-2,7-dienoyl-CoA"	"trans,cis-myristo-2,7-dienoyl-CoA"	"p, m"
"cis-(3S)-hydroxytetradec-7-enoyl-CoA"	"cis-(3S)-hydroxytetradec-7-enoyl-CoA"	"p, m"
"3-oxomyrist-7-enoyl-CoA"	"3-oxomyrist-7-enoyl-CoA"	"p, m"
"(5Z)-dodecenoyl-CoA"	"(5Z)-dodecenoyl-CoA"	"p, m"
"phytanoyl-CoA"	"phytanoyl-CoA"	"p"
"2-hydroxyphytanoyl-CoA"	"2-hydroxyphytanoyl-CoA"	"p"
"2(S)-pristanal"	"2(S)-pristanal"	"p"
"formyl-CoA"	"formyl-CoA"	"p"
"(2R,6S,10S)-pristanate"	"(2R,6S,10S)-pristanate"	"p"
"(2S)-pristanoyl-CoA"	"(2S)-pristanoyl-CoA"	"p"
"(2R)-pristanoyl-CoA"	"(2R)-pristanoyl-CoA"	"p"
"trans-2,3-dehydropristanoyl-CoA"	"trans-2,3-dehydropristanoyl-CoA"	"p"
"3-hydroxypristanoyl-CoA"	"3-hydroxypristanoyl-CoA"	"p"
"3-ketopristanoyl-CoA"	"3-ketopristanoyl-CoA"	"p"
"4,8,12-trimethyltridecanoyl-CoA"	"4,8,12-trimethyltridecanoyl-CoA"	"p"
"(4R,8R,12R)-trimethyl-(2E)-tridecenoyl-CoA"	"(4R,8R,12R)-trimethyl-(2E)-tridecenoyl-CoA"	"p"
"3(R)-hydroxy-(4R,8R,12R)-trimethyl-tridecanoyl-CoA"	"3(R)-hydroxy-(4R,8R,12R)-trimethyl-tridecanoyl-CoA"	"p"
"3-oxo-(4R,8R,12R)-trimethyl-tridecanoyl-CoA"	"3-oxo-(4R,8R,12R)-trimethyl-tridecanoyl-CoA"	"p"
"(2R,6R,10R)-trimethyl-hendecanoyl-CoA"	"(2R,6R,10R)-trimethyl-hendecanoyl-CoA"	"p"
"(2S,6R,10R)-trimethyl-hendecanoyl-CoA"	"(2S,6R,10R)-trimethyl-hendecanoyl-CoA"	"p"
"(2S,6R,10R)-trimethyl-(2E)-hendecenoyl-CoA"	"(2S,6R,10R)-trimethyl-(2E)-hendecenoyl-CoA"	"p"
"3(R)-hydroxy-(2S,6R,10)-trimethyl-hendecanoyl-CoA"	"3(R)-hydroxy-(2S,6R,10)-trimethyl-hendecanoyl-CoA"	"p"
"3-oxo-(2S,6R,10R)-trimethyl-hendecanoyl-CoA"	"3-oxo-(2S,6R,10R)-trimethyl-hendecanoyl-CoA"	"p"
"4(R),8-dimethyl-nonanoyl-CoA"	"4(R),8-dimethyl-nonanoyl-CoA"	"p, m"
"trans,cis,cis-2,9,12-octadecatrienoyl-CoA"	"trans,cis,cis-2,9,12-octadecatrienoyl-CoA"	"p, m"
"(3S)-3-hydroxylinoleoyl-CoA"	"(3S)-3-hydroxylinoleoyl-CoA"	"p, m"
"3-oxolinoleoyl-CoA"	"3-oxolinoleoyl-CoA"	"p, m"
"cis,cis-palmito-7,10-dienoyl-CoA"	"cis,cis-palmito-7,10-dienoyl-CoA"	"p, m"
"(3S)-3-hydroxy-cis,cis-palmito-7,10-dienoyl-CoA"	"(3S)-3-hydroxy-cis,cis-palmito-7,10-dienoyl-CoA"	"p, m"
"3-oxo-cis,cis-7,10-hexadecadienoyl-CoA"	"3-oxo-cis,cis-7,10-hexadecadienoyl-CoA"	"p, m"
"cis,cis-myristo-5,8-dienoyl-CoA"	"cis,cis-myristo-5,8-dienoyl-CoA"	"p, m"
"trans-2-cis,cis-5,8-tetradecatrienoyl-CoA"	"trans-2-cis,cis-5,8-tetradecatrienoyl-CoA"	"p, m"
"3(S)-hydroxy-(5Z,8Z)-tetradecadienoyl-CoA"	"3(S)-hydroxy-(5Z,8Z)-tetradecadienoyl-CoA"	"p, m"
"3-oxo-cis,cis-5,8-tetradecadienoyl-CoA"	"3-oxo-cis,cis-5,8-tetradecadienoyl-CoA"	"p, m"
"cis,cis-3,6-dodecadienoyl-CoA"	"cis,cis-3,6-dodecadienoyl-CoA"	"p, m"
"trans,cis-lauro-2,6-dienoyl-CoA"	"trans,cis-lauro-2,6-dienoyl-CoA"	"p, m"
"(3S)-3-hydroxydodec-cis-6-enoyl-CoA"	"(3S)-3-hydroxydodec-cis-6-enoyl-CoA"	"p, m"
"3-oxolaur-6-cis-enoyl-CoA"	"3-oxolaur-6-cis-enoyl-CoA"	"p, m"
"4-cis-decenoyl-CoA"	"4-cis-decenoyl-CoA"	"p, m"
"2-trans-4-cis-decadienoyl-CoA"	"2-trans-4-cis-decadienoyl-CoA"	"p, m"
"trans-3-decenoyl-CoA"	"trans-3-decenoyl-CoA"	"p, m"
"(2E)-heptadecenoyl-CoA"	"(2E)-heptadecenoyl-CoA"	"m"
"3-hydroxyheptadecanoyl-CoA"	"3-hydroxyheptadecanoyl-CoA"	"m"
"3-oxoheptadecanoyl-CoA"	"3-oxoheptadecanoyl-CoA"	"m"
"(2E)-pentadecenoyl-CoA"	"(2E)-pentadecenoyl-CoA"	"m"
"3-hydroxypentadecanoyl-CoA"	"3-hydroxypentadecanoyl-CoA"	"m"
"3-oxopentadecanoyl-CoA"	"3-oxopentadecanoyl-CoA"	"m"
"(2E)-tridecenoyl-CoA"	"(2E)-tridecenoyl-CoA"	"m"
"3-hydroxytridecanoyl-CoA"	"3-hydroxytridecanoyl-CoA"	"m"
"3-oxotridecanoyl-CoA"	"3-oxotridecanoyl-CoA"	"m"
"(2E)-undecenoyl-CoA"	"(2E)-undecenoyl-CoA"	"m"
"3-hydroxyundecanoyl-CoA"	"3-hydroxyundecanoyl-CoA"	"m"
"3-oxoundecanoyl-CoA"	"3-oxoundecanoyl-CoA"	"m"
"(2E)-nonenoyl-CoA"	"(2E)-nonenoyl-CoA"	"m"
"3-hydroxynonanoyl-CoA"	"3-hydroxynonanoyl-CoA"	"m"
"3-oxononanoyl-CoA"	"3-oxononanoyl-CoA"	"m"
"(2E)-heptenoyl-CoA"	"(2E)-heptenoyl-CoA"	"m"
"3-hydroxyheptanoyl-CoA"	"3-hydroxyheptanoyl-CoA"	"m"
"3-oxoheptanoyl-CoA"	"3-oxoheptanoyl-CoA"	"m"
"(2E)-pentenoyl-CoA"	"(2E)-pentenoyl-CoA"	"m"
"3-hydroxypentanoyl-CoA"	"3-hydroxypentanoyl-CoA"	"m"
"3-oxopentanoyl-CoA"	"3-oxopentanoyl-CoA"	"m"
"trans,cis-octadeca-2,11-dienoyl-CoA"	"trans,cis-octadeca-2,11-dienoyl-CoA"	"m, p"
"(S)-3-hydroxy-11-cis-octadecenoyl-CoA"	"(S)-3-hydroxy-11-cis-octadecenoyl-CoA"	"m, p"
"3-oxo-11-cis-octadecenoyl-CoA"	"3-oxo-11-cis-octadecenoyl-CoA"	"m, p"
"8(R)-hydroxy-hexadeca-(4E,6E,10Z)-trienoate"	"8(R)-hydroxy-hexadeca-(4E,6E,10Z)-trienoate"	"m"
"8(R)-hydroxy-hexadeca-(2E,4E,6E,10Z)-tetraenoate"	"8(R)-hydroxy-hexadeca-(2E,4E,6E,10Z)-tetraenoate"	"m"
"8(R)-hydroxy-hexadeca-(2E,6E,10Z)-trienoate"	"8(R)-hydroxy-hexadeca-(2E,6E,10Z)-trienoate"	"m"
"3(S),8(R)-dihydroxy-(6E,10Z)-hexadecadienoate"	"3(S),8(R)-dihydroxy-(6E,10Z)-hexadecadienoate"	"m"
"3-oxo-8(R)-hydroxy-hexadeca-(6E,10Z)-dienoate"	"3-oxo-8(R)-hydroxy-hexadeca-(6E,10Z)-dienoate"	"m"
"6(R)-hydroxy-tetradeca-(4E,8Z)-dienoate"	"6(R)-hydroxy-tetradeca-(4E,8Z)-dienoate"	"m"
"6(R)-hydroxy-tetradeca-(2E,4E,8Z)-trienoate"	"6(R)-hydroxy-tetradeca-(2E,4E,8Z)-trienoate"	"m"
"6(R)-hydroxy-tetradeca-(2E,8Z)-dienoate"	"6(R)-hydroxy-tetradeca-(2E,8Z)-dienoate"	"m"
"3(S),6(R)-dihydroxy-tetradec-(8Z)-enoate"	"3(S),6(R)-dihydroxy-tetradec-(8Z)-enoate"	"m"
"3-oxo-6(R)-hydroxy-tetradec-8-cis-enoate"	"3-oxo-6(R)-hydroxy-tetradec-8-cis-enoate"	"m"
"4(R)-hydroxy-dodec-(6Z)-enoate"	"4(R)-hydroxy-dodec-(6Z)-enoate"	"m"
"8(S)-hydroxy-hexadeca-(4E,6E,10Z)-trienoate"	"8(S)-hydroxy-hexadeca-(4E,6E,10Z)-trienoate"	"m"
"8(S)-hydroxy-hexadeca-(2E,4E,6E,10Z)-tetraenoate"	"8(S)-hydroxy-hexadeca-(2E,4E,6E,10Z)-tetraenoate"	"m"
"8(S)-hydroxy-hexadeca-(2E,6E,10Z)-trienoate"	"8(S)-hydroxy-hexadeca-(2E,6E,10Z)-trienoate"	"m"
"3(S),8(S)-dihydroxy-(6E,10Z)-hexadecadienoate"	"3(S),8(S)-dihydroxy-(6E,10Z)-hexadecadienoate"	"m"
"3-oxo-8(S)-hydroxy-hexadeca-(6E,10Z)-dienoate"	"3-oxo-8(S)-hydroxy-hexadeca-(6E,10Z)-dienoate"	"m"
"6(S)-hydroxy-tetradeca-(4E,8Z)-dienoate"	"6(S)-hydroxy-tetradeca-(4E,8Z)-dienoate"	"m"
"6(S)-hydroxy-tetradeca-(2E,4E,8Z)-trienoate"	"6(S)-hydroxy-tetradeca-(2E,4E,8Z)-trienoate"	"m"
"6(S)-hydroxy-tetradeca-(2E,8Z)-dienoate"	"6(S)-hydroxy-tetradeca-(2E,8Z)-dienoate"	"m"
"3(S),6(S)-dihydroxy-tetradec-(8Z)-enoate"	"3(S),6(S)-dihydroxy-tetradec-(8Z)-enoate"	"m"
"3-oxo-6(S)-hydroxy-tetradec-(8Z)-enoate"	"3-oxo-6(S)-hydroxy-tetradec-(8Z)-enoate"	"m"
"4(S)-hydroxy-dodec-(6Z)-enoate"	"4(S)-hydroxy-dodec-(6Z)-enoate"	"m"
"4(R),8-dimethyl-trans-2-nonenoyl-CoA"	"4(R),8-dimethyl-trans-2-nonenoyl-CoA"	"m"
"3(S)-hydroxy-4(R),8-dimethyl-nonanoyl-CoA"	"3(S)-hydroxy-4(R),8-dimethyl-nonanoyl-CoA"	"m"
"3-oxo-4(R),8-dimethyl-nonanoyl-CoA"	"3-oxo-4(R),8-dimethyl-nonanoyl-CoA"	"m"
"2(R),6-dimethyl-heptanoyl-CoA"	"2(R),6-dimethyl-heptanoyl-CoA"	"m"
"2(S),6-dimethyl-heptanoyl-CoA"	"2(S),6-dimethyl-heptanoyl-CoA"	"m"
"2,6-dimethyl-trans-2-heptenoyl-CoA"	"2,6-dimethyl-trans-2-heptenoyl-CoA"	"m"
"3(S)-hydroxy-2(S),6-dimethyl-heptanoyl-CoA"	"3(S)-hydroxy-2(S),6-dimethyl-heptanoyl-CoA"	"m"
"3-oxo-(2S)-methylisocapryloyl-CoA"	"3-oxo-(2S)-methylisocapryloyl-CoA"	"m"
"4-methyl-pentanoyl-CoA"	"4-methyl-pentanoyl-CoA"	"m"
"4-methyl-trans-2-pentenoyl-CoA"	"4-methyl-trans-2-pentenoyl-CoA"	"m"
"3(S)-hydroxy-4-methyl-pentanoyl-CoA"	"3(S)-hydroxy-4-methyl-pentanoyl-CoA"	"m"
"3-oxo-4-methyl-pentanoyl-CoA"	"3-oxo-4-methyl-pentanoyl-CoA"	"m"
"isopentenyl-pPP"	"isopentenyl-pPP"	"c"
"all-trans-decaprenyl-diphosphate"	"all-trans-decaprenyl-diphosphate"	"c, m"
"4-hydroxybenzoate"	"4-hydroxybenzoate"	"m"
"3-decaprenyl-4-hydroxybenzoate"	"3-decaprenyl-4-hydroxybenzoate"	"m"
"3,4-dihydroxy-5-all-trans-decaprenylbenzoate"	"3,4-dihydroxy-5-all-trans-decaprenylbenzoate"	"m"
"3-methoxy-4-hydroxy-5-all-trans-decaprenylbenzoate"	"3-methoxy-4-hydroxy-5-all-trans-decaprenylbenzoate"	"m"
"2-methoxy-6-(all-trans-decaprenyl)phenol"	"2-methoxy-6-(all-trans-decaprenyl)phenol"	"m"
"2-methoxy-6-alltrans-decaprenyl-2-methoxy-1,4-benzoquinol"	"2-methoxy-6-alltrans-decaprenyl-2-methoxy-1,4-benzoquinol"	"m"
"6-methoxy-3-methyl-2-all-trans-decaprenyl-1,4-benzoquinol"	"6-methoxy-3-methyl-2-all-trans-decaprenyl-1,4-benzoquinol"	"m"
"3-demethylubiquinol-10"	"3-demethylubiquinol-10"	"m"
"[protein]-L-cysteine"	"[protein]-L-cysteine"	"c"
"S-farnesyl-protein"	"S-farnesyl-protein"	"c"
"[proteinCterminal]-S-farnesyl-L-cysteine"	"[proteinCterminal]-S-farnesyl-L-cysteine"	"c"
"[proteinCterminal]-S-farnesyl-L-cysteine-methylester"	"[proteinCterminal]-S-farnesyl-L-cysteine-methylester"	"c"
"farnesylcysteine"	"farnesylcysteine"	"c"
"2-trans,6-trans-farnesal"	"2-trans,6-trans-farnesal"	"c"
"phylloquinone"	"phylloquinone"	"c"
"phylloquinol"	"phylloquinol"	"c"
"3alpha,7alpha,12alpha-trihydroxy-5beta-cholest-24-enoyl-CoA"	"3alpha,7alpha,12alpha-trihydroxy-5beta-cholest-24-enoyl-CoA"	"m, p"
"(24R,25R)3alpha,7alpha,12alpha,24-tetrahydroxy-5beta-cholestanoyl-CoA"	"(24R,25R)3alpha,7alpha,12alpha,24-tetrahydroxy-5beta-cholestanoyl-CoA"	"m, p"
"3alpha,7alpha,12alpha-trihydroxy-5beta-24-oxocholestanoyl-CoA"	"3alpha,7alpha,12alpha-trihydroxy-5beta-24-oxocholestanoyl-CoA"	"m, p"
"cholesterol"	"cholesterol"	"c, m, l, r, e, g"
"cholesterol-STAR"	"cholesterol-STAR"	"c"
"22beta-hydroxycholesterol"	"22beta-hydroxycholesterol"	"m"
"20alpha,22betadihydroxycholesterol"	"20alpha,22betadihydroxycholesterol"	"m, c"
"isocaproic-aldehyde"	"isocaproic-aldehyde"	"m, c"
"pregnenolone"	"pregnenolone"	"m, c"
"reducedadrenalferredoxin"	"reducedadrenalferredoxin"	"c"
"20-hydroxycholesterol"	"20-hydroxycholesterol"	"c, r"
"oxidizedadrenalferredoxin"	"oxidizedadrenalferredoxin"	"c"
"17alpha,20alpha-dihydroxycholesterol"	"17alpha,20alpha-dihydroxycholesterol"	"c"
"17alpha-hydroxypregnenolone"	"17alpha-hydroxypregnenolone"	"c, r"
"7alpha-hydroxypregnenolone"	"7alpha-hydroxypregnenolone"	"c"
"4-androstene-3,17-dione"	"4-androstene-3,17-dione"	"r, c"
"estrone"	"estrone"	"r, c, l, m, p"
"testosterone"	"testosterone"	"r, c"
"estradiol-17beta"	"estradiol-17beta"	"r, c"
"cortisone"	"cortisone"	"r, c"
"cortisol"	"cortisol"	"r, c, m"
"dehydroepiandrosterone"	"dehydroepiandrosterone"	"c, r"
"5-alpha-dihydrotestosterone"	"5-alpha-dihydrotestosterone"	"c, r"
"5alpha-androstane-3,17-dione"	"5alpha-androstane-3,17-dione"	"r"
"(R)-mevalonate"	"(R)-mevalonate"	"c, p"
"(R)-5-diphosphomevalonate"	"(R)-5-diphosphomevalonate"	"c"
"(R)-5-phosphomevalonate"	"(R)-5-phosphomevalonate"	"c"
"presqualene-PP"	"presqualene-PP"	"c"
"squalene"	"squalene"	"c"
"squalene2,3-oxide"	"squalene2,3-oxide"	"c"
"lanosterol"	"lanosterol"	"c"
"4,4-dimethyl-5alpha-cholesta-8,14,24-trien-3beta-ol"	"4,4-dimethyl-5alpha-cholesta-8,14,24-trien-3beta-ol"	"c"
"14-demethyllanosterol"	"14-demethyllanosterol"	"c"
"4alpha-carboxy-4beta-methyl-5alpha-cholesta-8,24-dien-3beta-ol"	"4alpha-carboxy-4beta-methyl-5alpha-cholesta-8,24-dien-3beta-ol"	"c"
"3-keto-4-methylzymosterol"	"3-keto-4-methylzymosterol"	"c"
"4alpha-methylzymosterol"	"4alpha-methylzymosterol"	"c"
"4alpha-carboxy-5alpha-cholesta-8,24-dien-3beta-ol"	"4alpha-carboxy-5alpha-cholesta-8,24-dien-3beta-ol"	"c"
"5alpha-cholesta-8,24-dien-3-one"	"5alpha-cholesta-8,24-dien-3-one"	"c"
"zymosterol"	"zymosterol"	"c"
"5alpha-cholesta-7,24-dien-3beta-ol"	"5alpha-cholesta-7,24-dien-3beta-ol"	"c"
"7-dehydrodesmosterol"	"7-dehydrodesmosterol"	"c"
"desmosterol"	"desmosterol"	"c"
"lathosterol"	"lathosterol"	"c"
"provitaminD3"	"provitaminD3"	"c"
"24,25-dihydrolanosterol"	"24,25-dihydrolanosterol"	"c"
"4,4-dimethyl-5alpha-cholesta-8,14-dien-3-beta-ol"	"4,4-dimethyl-5alpha-cholesta-8,14-dien-3-beta-ol"	"c"
"4,4-dimethyl-5alpha-cholesta-8-en-3-beta-ol"	"4,4-dimethyl-5alpha-cholesta-8-en-3-beta-ol"	"c"
"4alpha-carboxy-4beta-methyl-5alpha-cholesta-8-en-3beta-ol"	"4alpha-carboxy-4beta-methyl-5alpha-cholesta-8-en-3beta-ol"	"c"
"4alpha-methyl-5alpha-cholesta-8-en-3-one"	"4alpha-methyl-5alpha-cholesta-8-en-3-one"	"c"
"4alpha-methyl-cholesta-8-enol"	"4alpha-methyl-cholesta-8-enol"	"c"
"4alpha-carboxy-5alpha-cholesta-8-en-3beta-ol"	"4alpha-carboxy-5alpha-cholesta-8-en-3beta-ol"	"c"
"5alpha-cholesta-8-en-3-one"	"5alpha-cholesta-8-en-3-one"	"c"
"cholestenol"	"cholestenol"	"c"
"geranyl-PP"	"geranyl-PP"	"c"
"27alpha-hydroxy-7-dehydrocholesterol"	"27alpha-hydroxy-7-dehydrocholesterol"	"c"
"19-hydroxytestosterone"	"19-hydroxytestosterone"	"c"
"19-oxo-testosterone"	"19-oxo-testosterone"	"c"
"19-hydroxyandrostenedione"	"19-hydroxyandrostenedione"	"c"
"19-oxoandrostenedione"	"19-oxoandrostenedione"	"c"
"2-hydroxyestradiol-17beta"	"2-hydroxyestradiol-17beta"	"c, r, l"
"2-hydroxy-3-methoxy-17beta-estradiol"	"2-hydroxy-3-methoxy-17beta-estradiol"	"c"
"2-methoxyestradiol-17beta"	"2-methoxyestradiol-17beta"	"c"
"4-hydroxy-17beta-estradiol"	"4-hydroxy-17beta-estradiol"	"c, l, m, r, p"
"4-methoxy-17beta-estradiol"	"4-methoxy-17beta-estradiol"	"c"
"4-hydroxyestrone"	"4-hydroxyestrone"	"c, l, r, m, p"
"4-methoxyestrone"	"4-methoxyestrone"	"c"
"16alpha-hydroxyestrone"	"16alpha-hydroxyestrone"	"c, r"
"2-hydroxyestrone"	"2-hydroxyestrone"	"c, r, l, m, p"
"2-methoxyestrone"	"2-methoxyestrone"	"c, r"
"2-hydroxy-3-methoxyestrone"	"2-hydroxy-3-methoxyestrone"	"c"
"estrone-2,3-semiquinone"	"estrone-2,3-semiquinone"	"c, l, r"
"2-hydroxyestrone-1-S-glutathione"	"2-hydroxyestrone-1-S-glutathione"	"c, m, r, p"
"estrone-2,3-quinone"	"estrone-2,3-quinone"	"c, m, r, p"
"2-hydroxyestrone-4-S-glutathione"	"2-hydroxyestrone-4-S-glutathione"	"c, m, r, p"
"estrone-3,4-semiquinone"	"estrone-3,4-semiquinone"	"c, l, r"
"4-hydroxyestrone-2-S-glutathione"	"4-hydroxyestrone-2-S-glutathione"	"c, m, r, p"
"estrone-3,4-quinone"	"estrone-3,4-quinone"	"c, m, r, p"
"17beta-estradiol-3,4-semiquinone"	"17beta-estradiol-3,4-semiquinone"	"c, l"
"17beta-estradiol-3,4-quinone"	"17beta-estradiol-3,4-quinone"	"c, m, r, p"
"4-hydroxy-17beta-estradiol-2-S-glutathione"	"4-hydroxy-17beta-estradiol-2-S-glutathione"	"c, m, r, p"
"17beta-estradiol-2,3-semiquinone"	"17beta-estradiol-2,3-semiquinone"	"c, l"
"17beta-estradiol-2,3-quinone"	"17beta-estradiol-2,3-quinone"	"c, m, r, p"
"2-hydroxy-17beta-estradiol-4-S-glutathione"	"2-hydroxy-17beta-estradiol-4-S-glutathione"	"c, m, r, p"
"2-hydroxy-17beta-estradiol-1-S-glutathione"	"2-hydroxy-17beta-estradiol-1-S-glutathione"	"c, m, r, p"
"cholesterol-ester-laur"	"cholesterol-ester-laur"	"l, r"
"cholesterol-ester-tridec"	"cholesterol-ester-tridec"	"l, r"
"cholesterol-ester-myrist"	"cholesterol-ester-myrist"	"l, r"
"cholesterol-ester-9-tetrade"	"cholesterol-ester-9-tetrade"	"l, r"
"cholesterol-ester-7-tetrade"	"cholesterol-ester-7-tetrade"	"l, r"
"cholesterol-ester-5-tetra"	"cholesterol-ester-5-tetra"	"l, r"
"cholesterol-ester-penta"	"cholesterol-ester-penta"	"l, r"
"cholesterol-ester-palm"	"cholesterol-ester-palm"	"l, r"
"cholesterol-ester-7-hexa"	"cholesterol-ester-7-hexa"	"l, r"
"cholesterol-ester-palmn"	"cholesterol-ester-palmn"	"l, r"
"cholesterol-ester-hepta"	"cholesterol-ester-hepta"	"l, r"
"cholesterol-ester-10-hepta"	"cholesterol-ester-10-hepta"	"l, r"
"cholesterol-ester-9-heptade"	"cholesterol-ester-9-heptade"	"l, r"
"cholesterol-ester-stea"	"cholesterol-ester-stea"	"l, r"
"cholesterol-ester-ol"	"cholesterol-ester-ol"	"l, r"
"cholesterol-ester-13-octade"	"cholesterol-ester-13-octade"	"l, r"
"cholesterol-ester-cis-vac"	"cholesterol-ester-cis-vac"	"l, r"
"cholesterol-ester-9-octa"	"cholesterol-ester-9-octa"	"l, r"
"cholesterol-ester-7-octade"	"cholesterol-ester-7-octade"	"l, r"
"cholesterol-ester-6,9-octa"	"cholesterol-ester-6,9-octa"	"l, r"
"cholesterol-ester-nanode"	"cholesterol-ester-nanode"	"l, r"
"cholesterol-ester-eico"	"cholesterol-ester-eico"	"l, r"
"cholesterol-ester-13-eicose"	"cholesterol-ester-13-eicose"	"l, r"
"cholesterol-ester-11-eico"	"cholesterol-ester-11-eico"	"l, r"
"cholesterol-ester-9-eicose"	"cholesterol-ester-9-eicose"	"l, r"
"cholesterol-ester-8,11-eico"	"cholesterol-ester-8,11-eico"	"l, r"
"cholesterol-ester-5,8,11-eico"	"cholesterol-ester-5,8,11-eico"	"l, r"
"cholesterol-ester-heneico"	"cholesterol-ester-heneico"	"l, r"
"cholesterol-ester-docosa"	"cholesterol-ester-docosa"	"l, r"
"cholesterol-ester-13-docose"	"cholesterol-ester-13-docose"	"l, r"
"cholesterol-ester-11-docose"	"cholesterol-ester-11-docose"	"l, r"
"cholesterol-ester-trico"	"cholesterol-ester-trico"	"l, r"
"cholesterol-ester-tetraco"	"cholesterol-ester-tetraco"	"l, r"
"cholesterol-ester-15-tetra"	"cholesterol-ester-15-tetra"	"l, r"
"cholesterol-ester-hexacosa"	"cholesterol-ester-hexacosa"	"l, r"
"cholesterol-ester-hexecose"	"cholesterol-ester-hexecose"	"l, r"
"cholesterol-ester-linolen"	"cholesterol-ester-linolen"	"l, r"
"cholesterol-ester-6,9,12,15-octa"	"cholesterol-ester-6,9,12,15-octa"	"l, r"
"cholesterol-ester-8,11,14,17-eico"	"cholesterol-ester-8,11,14,17-eico"	"l, r"
"cholesterol-ester-5,8,11,14,17-eico"	"cholesterol-ester-5,8,11,14,17-eico"	"l, r"
"cholesterol-ester-7,10,13,16,19-docosa"	"cholesterol-ester-7,10,13,16,19-docosa"	"l, r"
"cholesterol-ester-9,12,15,18,21-tetra"	"cholesterol-ester-9,12,15,18,21-tetra"	"l, r"
"cholesterol-ester-6,9,12,15,18,21-tetra"	"cholesterol-ester-6,9,12,15,18,21-tetra"	"l, r"
"cholesterol-ester-4,7,10,13,16,19-doco"	"cholesterol-ester-4,7,10,13,16,19-doco"	"l, r"
"cholesterol-ester-11,14,17-eico"	"cholesterol-ester-11,14,17-eico"	"l, r"
"cholesterol-ester-13,16,19-doco"	"cholesterol-ester-13,16,19-doco"	"l, r"
"cholesterol-ester-10,13,16,19-docosa"	"cholesterol-ester-10,13,16,19-docosa"	"l, r"
"cholesterol-ester-12,15,18,21-tetracosa"	"cholesterol-ester-12,15,18,21-tetracosa"	"l, r"
"cholesterol-ester-lin"	"cholesterol-ester-lin"	"l, r"
"cholesterol-ester-gamma-lin"	"cholesterol-ester-gamma-lin"	"l, r"
"cholesterol-ester-dihomo-gamma"	"cholesterol-ester-dihomo-gamma"	"l, r"
"cholesterol-ester-arach"	"cholesterol-ester-arach"	"l, r"
"cholesterol-ester-7,10,13,16-docosa"	"cholesterol-ester-7,10,13,16-docosa"	"l, r"
"cholesterol-ester-9,12,15,18-tetraco"	"cholesterol-ester-9,12,15,18-tetraco"	"l, r"
"cholesterol-ester-6,9,12,15,18-tetraco"	"cholesterol-ester-6,9,12,15,18-tetraco"	"l, r"
"cholesterol-ester-4,7,10,13,16-docosa"	"cholesterol-ester-4,7,10,13,16-docosa"	"l, r"
"cholesterol-ester-11,14-eicosa"	"cholesterol-ester-11,14-eicosa"	"l, r"
"cholesterol-ester-13,16-docosa"	"cholesterol-ester-13,16-docosa"	"l, r"
"cholesterol-ester-10,13,16-docosa"	"cholesterol-ester-10,13,16-docosa"	"l, r"
"phytoceramidepool"	"phytoceramidepool"	"c"
"phytosphingosine"	"phytosphingosine"	"c"
"ceramidepool"	"ceramidepool"	"g, c, l, r"
"acyl-CoA-LD-SMpool"	"acyl-CoA-LD-SMpool"	"g, c"
"sphingosine"	"sphingosine"	"g, c, e, l, r"
"PC-LDpool"	"PC-LDpool"	"g, c, r, l, e"
"SMpool"	"SMpool"	"g, c, l"
"3-dehydrosphinganine"	"3-dehydrosphinganine"	"c"
"sphinganine"	"sphinganine"	"c, r"
"sphinganine-1-phosphate"	"sphinganine-1-phosphate"	"c, r"
"ethanolamine-phosphate"	"ethanolamine-phosphate"	"c, r"
"hexadecanal"	"hexadecanal"	"c, r"
"dihydroceramidepool"	"dihydroceramidepool"	"c"
"ceramide-1Ppool"	"ceramide-1Ppool"	"c"
"glucosylceramidepool"	"glucosylceramidepool"	"c, r, e, l, g"
"LacCerpool"	"LacCerpool"	"r, e, g, l, c"
"sphingosine-1-phosphate"	"sphingosine-1-phosphate"	"c, e, r"
"hexadecenal"	"hexadecenal"	"c"
"phosphocholine"	"phosphocholine"	"c, l"
"globotriaosylceramide"	"globotriaosylceramide"	"g, c, l"
"globoside"	"globoside"	"g, l, c"
"galactosylgloboside"	"galactosylgloboside"	"g, c"
"sialyl-galactosylgloboside"	"sialyl-galactosylgloboside"	"g"
"sialyl(1,3)-sialyl(2,6)-galactosylgloboside"	"sialyl(1,3)-sialyl(2,6)-galactosylgloboside"	"g"
"sialyl(2,3)-sialyl(2,6)-galactosylgloboside"	"sialyl(2,3)-sialyl(2,6)-galactosylgloboside"	"g"
"disialylgalactosylgloboside"	"disialylgalactosylgloboside"	"g"
"GA2"	"GA2"	"g, c"
"GA1"	"GA1"	"g, c"
"GM1b"	"GM1b"	"g, c"
"GD1alpha"	"GD1alpha"	"g"
"GT1aalpha"	"GT1aalpha"	"g, c"
"GQ1balpha"	"GQ1balpha"	"g, c"
"GD1c"	"GD1c"	"g, c"
"GM2alpha"	"GM2alpha"	"g"
"GM1alpha"	"GM1alpha"	"g"
"GD1beta"	"GD1beta"	"g"
"GD1a"	"GD1a"	"g, c"
"GT1c"	"GT1c"	"g"
"GQ1c"	"GQ1c"	"g"
"GP1c"	"GP1c"	"g"
"GT1b"	"GT1b"	"g, c"
"GM3"	"GM3"	"g, c, l"
"GD3"	"GD3"	"g, c"
"GT3"	"GT3"	"g, c"
"GQ1b"	"GQ1b"	"g, c"
"GT1a"	"GT1a"	"g, c"
"GP1calpha"	"GP1calpha"	"g"
"GM1"	"GM1"	"g, c, l"
"GD1b"	"GD1b"	"g, c"
"GM2"	"GM2"	"g, c, l"
"GD2"	"GD2"	"g, c"
"GT2"	"GT2"	"g, c"
"alpha-GalNAc-globoside"	"alpha-GalNAc-globoside"	"g, l"
"sulfatidegalactocerebroside"	"sulfatidegalactocerebroside"	"l"
"D-galactosyl-N-acylsphingosine"	"D-galactosyl-N-acylsphingosine"	"l, c, g"
"digalactosylceramide"	"digalactosylceramide"	"l, c, g"
"fucosyl-galactosylgloboside"	"fucosyl-galactosylgloboside"	"g"
"9-O-acetylated-GD3"	"9-O-acetylated-GD3"	"c, g"
"9-O-acetylated-GT3"	"9-O-acetylated-GT3"	"c, g"
"sphingosylphosphorylcholine"	"sphingosylphosphorylcholine"	"c"
"2-lysolecithinpool"	"2-lysolecithinpool"	"r, l, c"
"1-acylglycerol-3P-laur"	"1-acylglycerol-3P-laur"	"c"
"1-acylglycerol-3P-tridec"	"1-acylglycerol-3P-tridec"	"c"
"1-acylglycerol-3P-myrist"	"1-acylglycerol-3P-myrist"	"c"
"1-acylglycerol-3P-9-tetrade"	"1-acylglycerol-3P-9-tetrade"	"c"
"1-acylglycerol-3P-7-tetrade"	"1-acylglycerol-3P-7-tetrade"	"c"
"1-acylglycerol-3P-5-tetrade"	"1-acylglycerol-3P-5-tetrade"	"c"
"1-acylglycerol-3P-pentade"	"1-acylglycerol-3P-pentade"	"c"
"1-acylglycerol-3P-palm"	"1-acylglycerol-3P-palm"	"c"
"1-acylglycerol-3P-palmn"	"1-acylglycerol-3P-palmn"	"c"
"1-acylglycerol-3P-7-hexade"	"1-acylglycerol-3P-7-hexade"	"c"
"1-acylglycerol-3P-heptade"	"1-acylglycerol-3P-heptade"	"c"
"1-acylglycerol-3P-10-heptade"	"1-acylglycerol-3P-10-heptade"	"c"
"1-acylglycerol-3P-9-heptade"	"1-acylglycerol-3P-9-heptade"	"c"
"1-acylglycerol-3P-stea"	"1-acylglycerol-3P-stea"	"c"
"1-acylglycerol-3P-13-octade"	"1-acylglycerol-3P-13-octade"	"c"
"1-acylglycerol-3P-cis-vac"	"1-acylglycerol-3P-cis-vac"	"c"
"1-acylglycerol-3P-ol"	"1-acylglycerol-3P-ol"	"c"
"1-acylglycerol-3P-9-octade"	"1-acylglycerol-3P-9-octade"	"c"
"1-acylglycerol-3P-7-octade"	"1-acylglycerol-3P-7-octade"	"c"
"1-acylglycerol-3P-6,9-octa"	"1-acylglycerol-3P-6,9-octa"	"c"
"1-acylglycerol-3P-nanode"	"1-acylglycerol-3P-nanode"	"c"
"1-acylglycerol-3P-eico"	"1-acylglycerol-3P-eico"	"c"
"1-acylglycerol-3P-13-eicose"	"1-acylglycerol-3P-13-eicose"	"c"
"1-acylglycerol-3P-11-eico"	"1-acylglycerol-3P-11-eico"	"c"
"1-acylglycerol-3P-9-eicose"	"1-acylglycerol-3P-9-eicose"	"c"
"1-acylglycerol-3P-8,11-eico"	"1-acylglycerol-3P-8,11-eico"	"c"
"1-acylglycerol-3P-5,8,11-eico"	"1-acylglycerol-3P-5,8,11-eico"	"c"
"1-acylglycerol-3P-heneico"	"1-acylglycerol-3P-heneico"	"c"
"1-acylglycerol-3P-docosa"	"1-acylglycerol-3P-docosa"	"c"
"1-acylglycerol-3P-13-docose"	"1-acylglycerol-3P-13-docose"	"c"
"1-acylglycerol-3P-11-docose"	"1-acylglycerol-3P-11-docose"	"c"
"1-acylglycerol-3P-trico"	"1-acylglycerol-3P-trico"	"c"
"1-acylglycerol-3P-tetraco"	"1-acylglycerol-3P-tetraco"	"c"
"1-acylglycerol-3P-15-tetra"	"1-acylglycerol-3P-15-tetra"	"c"
"1-acylglycerol-3P-hexacosa"	"1-acylglycerol-3P-hexacosa"	"c"
"1-acylglycerol-3P-hexecose"	"1-acylglycerol-3P-hexecose"	"c"
"1-acylglycerol-3P-linolen"	"1-acylglycerol-3P-linolen"	"c"
"1-acylglycerol-3P-6,9,12,15-octa"	"1-acylglycerol-3P-6,9,12,15-octa"	"c"
"1-acylglycerol-3P-8,11,14,17-eico"	"1-acylglycerol-3P-8,11,14,17-eico"	"c"
"1-acylglycerol-3P-5,8,11,14,17-eico"	"1-acylglycerol-3P-5,8,11,14,17-eico"	"c"
"1-acylglycerol-3P-7,10,13,16,19-docosa"	"1-acylglycerol-3P-7,10,13,16,19-docosa"	"c"
"1-acylglycerol-3P-9,12,15,18,21-tetra"	"1-acylglycerol-3P-9,12,15,18,21-tetra"	"c"
"1-acylglycerol-3P-6,9,12,15,18,21-tetra"	"1-acylglycerol-3P-6,9,12,15,18,21-tetra"	"c"
"1-acylglycerol-3P-4,7,10,13,16,19-doco"	"1-acylglycerol-3P-4,7,10,13,16,19-doco"	"c"
"1-acylglycerol-3P-11,14,17-eico"	"1-acylglycerol-3P-11,14,17-eico"	"c"
"1-acylglycerol-3P-13,16,19-doco"	"1-acylglycerol-3P-13,16,19-doco"	"c"
"1-acylglycerol-3P-10,13,16,19-doco"	"1-acylglycerol-3P-10,13,16,19-doco"	"c"
"1-acylglycerol-3P-12,15,18,21-tetra"	"1-acylglycerol-3P-12,15,18,21-tetra"	"c"
"1-acylglycerol-3P-lin"	"1-acylglycerol-3P-lin"	"c"
"1-acylglycerol-3P-gamma-lin"	"1-acylglycerol-3P-gamma-lin"	"c"
"1-acylglycerol-3P-dihomo-gamma"	"1-acylglycerol-3P-dihomo-gamma"	"c"
"1-acylglycerol-3P-arach"	"1-acylglycerol-3P-arach"	"c"
"1-acylglycerol-3P-7,10,13,16-docosa"	"1-acylglycerol-3P-7,10,13,16-docosa"	"c"
"1-acylglycerol-3P-9,12,15,18-tetraco"	"1-acylglycerol-3P-9,12,15,18-tetraco"	"c"
"1-acylglycerol-3P-6,9,12,15,18-tetraco"	"1-acylglycerol-3P-6,9,12,15,18-tetraco"	"c"
"1-acylglycerol-3P-4,7,10,13,16-docosa"	"1-acylglycerol-3P-4,7,10,13,16-docosa"	"c"
"1-acylglycerol-3P-11,14-eicosa"	"1-acylglycerol-3P-11,14-eicosa"	"c"
"1-acylglycerol-3P-13,16-docosa"	"1-acylglycerol-3P-13,16-docosa"	"c"
"1-acylglycerol-3P-10,13,16-docosa"	"1-acylglycerol-3P-10,13,16-docosa"	"c"
"1-acylglycerol-3P-LD-TG1pool"	"1-acylglycerol-3P-LD-TG1pool"	"c"
"1-acylglycerol-3P-LD-PCpool"	"1-acylglycerol-3P-LD-PCpool"	"c"
"1-acylglycerol-3P-LD-PEpool"	"1-acylglycerol-3P-LD-PEpool"	"c"
"1-acylglycerol-3P-LD-PSpool"	"1-acylglycerol-3P-LD-PSpool"	"c"
"1-acylglycerol-3P-LD-PIpool"	"1-acylglycerol-3P-LD-PIpool"	"c"
"1-acylglycerol-3P-LD-SMpool"	"1-acylglycerol-3P-LD-SMpool"	"c"
"glycerone"	"glycerone"	"e"
"1-alkyl-2-acylglycerol"	"1-alkyl-2-acylglycerol"	"c"
"CDP-ethanolamine"	"CDP-ethanolamine"	"c"
"1-alkyl-2-acylglycerophosphoethanolamine"	"1-alkyl-2-acylglycerophosphoethanolamine"	"c"
"1,2-diacylglycerol-bile-PCpool"	"1,2-diacylglycerol-bile-PCpool"	"c"
"CDP-choline"	"CDP-choline"	"c"
"bile-PCpool"	"bile-PCpool"	"c"
"acyl-CoA-CLpool"	"acyl-CoA-CLpool"	"m"
"1-acylglycerol-3P-CLpool"	"1-acylglycerol-3P-CLpool"	"m"
"phosphatidate-CLpool"	"phosphatidate-CLpool"	"m"
"CDP-diacylglycerol-CLpool"	"CDP-diacylglycerol-CLpool"	"m"
"PGP-CLpool"	"PGP-CLpool"	"m"
"PG-CLpool"	"PG-CLpool"	"m"
"CLpool"	"CLpool"	"m"
"acyl-CoA-LD-PCpool"	"acyl-CoA-LD-PCpool"	"c"
"phosphatidate-LD-PCpool"	"phosphatidate-LD-PCpool"	"c, g, r"
"acyl-CoA-LD-PEpool"	"acyl-CoA-LD-PEpool"	"c"
"phosphatidate-LD-PEpool"	"phosphatidate-LD-PEpool"	"c"
"acyl-CoA-LD-PSpool"	"acyl-CoA-LD-PSpool"	"c"
"phosphatidate-LD-PSpool"	"phosphatidate-LD-PSpool"	"c"
"acyl-CoA-LD-PIpool"	"acyl-CoA-LD-PIpool"	"c"
"phosphatidate-LD-PIpool"	"phosphatidate-LD-PIpool"	"c"
"phosphatidate-LD-SMpool"	"phosphatidate-LD-SMpool"	"c"
"1-acylglycerol-3P-bile-PCpool"	"1-acylglycerol-3P-bile-PCpool"	"c"
"acyl-CoA-bile-PCpool"	"acyl-CoA-bile-PCpool"	"c"
"phosphatidate-bile-PCpool"	"phosphatidate-bile-PCpool"	"c"
"CDP-diacylglycerol-LD-PIpool"	"CDP-diacylglycerol-LD-PIpool"	"c, r"
"inositol"	"inositol"	"c, r, n, e"
"PIpool"	"PIpool"	"c, r, g, n"
"PE-LDpool"	"PE-LDpool"	"c, r"
"PE-PS-LDpool"	"PE-PS-LDpool"	"c"
"PS-LDpool"	"PS-LDpool"	"c"
"ethanolamine"	"ethanolamine"	"c, r"
"sn-glycerol-3-PC"	"sn-glycerol-3-PC"	"c"
"cholesterol-esterpool"	"cholesterol-esterpool"	"c, e, l"
"acetylcholine"	"acetylcholine"	"c, e"
"1-acyl-PEpool"	"1-acyl-PEpool"	"c"
"sn-glycerol-3-PE"	"sn-glycerol-3-PE"	"c"
"PE-NME-LDpool"	"PE-NME-LDpool"	"c"
"PPE-NME2-LDpool"	"PPE-NME2-LDpool"	"c"
"N-methylethanolamine-phosphate"	"N-methylethanolamine-phosphate"	"c"
"phosphodimethylethanolamine"	"phosphodimethylethanolamine"	"c"
"hexadecanol"	"hexadecanol"	"p"
"alkyl-glycerone-3-phosphate"	"alkyl-glycerone-3-phosphate"	"p"
"2-acetyl-1-alkyl-sn-glycero-3-phosphocholine"	"2-acetyl-1-alkyl-sn-glycero-3-phosphocholine"	"c, e"
"1-organyl-2-lyso-sn-glycero-3-phosphocholine"	"1-organyl-2-lyso-sn-glycero-3-phosphocholine"	"c, e"
"1-alkyl-2-lysoglycerol-3-phosphocholine"	"1-alkyl-2-lysoglycerol-3-phosphocholine"	"c, e"
"N-acetylgalactosamine"	"N-acetylgalactosamine"	"c, l"
"IV3GalNAca-Gb4Cer"	"IV3GalNAca-Gb4Cer"	"c"
"monosialylgalactosylgloboside"	"monosialylgalactosylgloboside"	"c"
"globo-H"	"globo-H"	"c"
"V3(NeuAc)2-Gb5Cer"	"V3(NeuAc)2-Gb5Cer"	"c"
"lc3Cer"	"lc3Cer"	"c, g"
"lc4Cer"	"lc4Cer"	"c, g"
"3-isoLM1"	"3-isoLM1"	"c"
"IV2Fuc-Lc4Cer"	"IV2Fuc-Lc4Cer"	"c"
"G00038"	"G00038"	"c"
"typeIBglycolipid"	"typeIBglycolipid"	"c"
"paragloboside"	"paragloboside"	"c"
"sialyl-3-paragloboside"	"sialyl-3-paragloboside"	"c, g"
"3,8-LD1"	"3,8-LD1"	"c, g"
"IV3NeuAc,III3Fuc-nLc4Cer"	"IV3NeuAc,III3Fuc-nLc4Cer"	"c, g"
"nLc5Cer(G00051)"	"nLc5Cer(G00051)"	"c"
"typeIIBantigen"	"typeIIBantigen"	"c"
"IV2Fuc-nLc4Cer"	"IV2Fuc-nLc4Cer"	"c"
"III3,IV2Fuc-nLc4Cer"	"III3,IV2Fuc-nLc4Cer"	"c"
"G00057"	"G00057"	"c"
"typeIIIHglycolipid"	"typeIIIHglycolipid"	"c, g"
"III3Fuc-nLc4Cer"	"III3Fuc-nLc4Cer"	"c"
"nLc5Cer"	"nLc5Cer"	"c, g"
"nLc6Cer"	"nLc6Cer"	"c, g"
"nLc7Cer"	"nLc7Cer"	"c, g"
"nLc8Cer"	"nLc8Cer"	"c, g"
"G00084"	"G00084"	"c"
"G00085"	"G00085"	"c"
"G00086"	"G00086"	"c"
"V3Fuc-nLc6Cer"	"V3Fuc-nLc6Cer"	"c, g"
"V3Fuc,III3Fuc-nLc6Cer"	"V3Fuc,III3Fuc-nLc6Cer"	"c"
"VI2Fuc-nLc6"	"VI2Fuc-nLc6"	"c, g"
"G00081"	"G00081"	"c"
"G00082"	"G00082"	"c"
"G00073"	"G00073"	"c"
"G00074"	"G00074"	"c"
"G00077"	"G00077"	"c, g"
"iso-nLc8Cer"	"iso-nLc8Cer"	"c"
"monofucosyllactoisooctaosylceramide"	"monofucosyllactoisooctaosylceramide"	"c"
"G00079"	"G00079"	"c"
"VI3NeuAc-nLc6Cer"	"VI3NeuAc-nLc6Cer"	"c, g"
"III3Fuc-nLc6Cer"	"III3Fuc-nLc6Cer"	"c, g"
"sulfatide"	"sulfatide"	"l"
"GM4"	"GM4"	"l"
"GM2A-GM2"	"GM2A-GM2"	"l"
"psychosine"	"psychosine"	"l"
"6-(alpha-D-glucosaminyl)-1-phosphatidyl-1D-myo-inositol"	"6-(alpha-D-glucosaminyl)-1-phosphatidyl-1D-myo-inositol"	"r, c"
"6-(alpha-D-glucosaminyl)-1D-myo-inositol"	"6-(alpha-D-glucosaminyl)-1D-myo-inositol"	"r"
"O-D-mannosylprotein"	"O-D-mannosylprotein"	"c"
"N-acetyl-D-glucosaminylphosphatidylinositol"	"N-acetyl-D-glucosaminylphosphatidylinositol"	"c, r"
"glucosaminyl-acylphosphatidylinositol"	"glucosaminyl-acylphosphatidylinositol"	"r"
"mgacpailheparansulfate"	"mgacpailheparansulfate"	"r"
"m2gacpailheparansulfate"	"m2gacpailheparansulfate"	"r"
"m3gacpailheparansulfate"	"m3gacpailheparansulfate"	"r"
"emgacpailheparansulfate"	"emgacpailheparansulfate"	"r"
"memgacpailheparansulfate"	"memgacpailheparansulfate"	"r"
"m2emgacpailheparansulfate"	"m2emgacpailheparansulfate"	"r"
"m3emgacpailheparansulfate"	"m3emgacpailheparansulfate"	"r"
"em2emgacpailheparansulfate"	"em2emgacpailheparansulfate"	"r"
"mem2emgacpailheparansulfate"	"mem2emgacpailheparansulfate"	"r"
"em3gacpailheparansulfate"	"em3gacpailheparansulfate"	"r"
"emem2gacpailheparansulfate"	"emem2gacpailheparansulfate"	"r"
"gpiheparansulfate"	"gpiheparansulfate"	"r"
"glycophosphatidylinositol-(GPI)-anchored-protein-precursor"	"glycophosphatidylinositol-(GPI)-anchored-protein-precursor"	"r"
"em2emgacpail_protheparansulfate"	"em2emgacpail_protheparansulfate"	"r"
"gpi_sig"	"gpi_sig"	"r"
"dem2emgacpail_protheparansulfate"	"dem2emgacpail_protheparansulfate"	"r"
"gpi_protheparansulfate"	"gpi_protheparansulfate"	"r"
"dgpi_protheparansulfate"	"dgpi_protheparansulfate"	"r"
"m3gacpail_protheparansulfate"	"m3gacpail_protheparansulfate"	"r"
"mem2emgacpail_protheparansulfate"	"mem2emgacpail_protheparansulfate"	"r"
"17alpha-hydroxyprogesterone"	"17alpha-hydroxyprogesterone"	"c, r"
"11beta-hydroxyandrost-4-ene-3,17-dione"	"11beta-hydroxyandrost-4-ene-3,17-dione"	"c, m, r"
"prostaglandinG2"	"prostaglandinG2"	"r"
"thromboxaneA2"	"thromboxaneA2"	"r"
"prostaglandinA2"	"prostaglandinA2"	"c"
"prostaglandinF2alpha"	"prostaglandinF2alpha"	"c, e"
"12(S)-HHT"	"12(S)-HHT"	"c"
"malonic-dialdehyde"	"malonic-dialdehyde"	"c"
"anandamide"	"anandamide"	"c"
"2-arachidonoylglycerol"	"2-arachidonoylglycerol"	"c"
"12-hydroperoxyeicosatetraenoate-glyceryl-ester"	"12-hydroperoxyeicosatetraenoate-glyceryl-ester"	"c"
"1-lyso-2-arachidonoyl-phosphatidate"	"1-lyso-2-arachidonoyl-phosphatidate"	"c"
"prostaglandinJ2"	"prostaglandinJ2"	"c"
"S-(PGJ2)-glutathione"	"S-(PGJ2)-glutathione"	"c"
"S-(PGA2)-glutathione"	"S-(PGA2)-glutathione"	"c"
"delta-12-prostaglandinJ2"	"delta-12-prostaglandinJ2"	"c"
"S-(9-deoxy-delta9,12-PGD2)-glutathione"	"S-(9-deoxy-delta9,12-PGD2)-glutathione"	"c"
"9-deoxy-delta12-PGD2"	"9-deoxy-delta12-PGD2"	"c"
"S-(9-deoxy-delta12-PGD2)-glutathione"	"S-(9-deoxy-delta12-PGD2)-glutathione"	"c"
"prostaglandinG1"	"prostaglandinG1"	"c, r"
"prostaglandinH1"	"prostaglandinH1"	"r, c"
"prostaglandinA1"	"prostaglandinA1"	"c"
"S-(PGA1)-glutathione"	"S-(PGA1)-glutathione"	"c"
"1-palmitoyl-dihydroxyacetone-phosphate"	"1-palmitoyl-dihydroxyacetone-phosphate"	"p"
"GO3P"	"GO3P"	"p, c"
"1-hexadecylglycerol-3-phosphate"	"1-hexadecylglycerol-3-phosphate"	"c"
"2-acyl-1-alkyl-sn-glycero-3-phosphate"	"2-acyl-1-alkyl-sn-glycero-3-phosphate"	"c"
"1-radyl-2-acyl-sn-glycero-3-phosphocholine"	"1-radyl-2-acyl-sn-glycero-3-phosphocholine"	"c"
"1-(1-alkenyl)-sn-glycero-3-phosphoethanolamine"	"1-(1-alkenyl)-sn-glycero-3-phosphoethanolamine"	"c"
"O-1-alk-1-enyl-2-acyl-sn-glycero-3-phosphoethanolamine"	"O-1-alk-1-enyl-2-acyl-sn-glycero-3-phosphoethanolamine"	"c"
"1-alkenyl-2-acylglycerol"	"1-alkenyl-2-acylglycerol"	"c"
"2-acyl-1-(1-alkenyl)-sn-glycero-3-phosphate"	"2-acyl-1-(1-alkenyl)-sn-glycero-3-phosphate"	"c"
"1-(1-alkenyl)-sn-glycerol"	"1-(1-alkenyl)-sn-glycerol"	"c"
"1-(1-alkenyl)-sn-glycero-3-phosphate"	"1-(1-alkenyl)-sn-glycero-3-phosphate"	"c"
"1-alkyl-2-acetyl-sn-glycerol"	"1-alkyl-2-acetyl-sn-glycerol"	"c"
"fattyacid-ligands"	"fattyacid-ligands"	"n"
"activation-ppara"	"activation-ppara"	"n, c, r, m, p, e"
"Xyl-L-Ser-[protein]"	"Xyl-L-Ser-[protein]"	"r, g"
"Gal-Xyl-L-Ser-[protein]"	"Gal-Xyl-L-Ser-[protein]"	"g"
"Gal2-Xyl-L-Ser-[protein]"	"Gal2-Xyl-L-Ser-[protein]"	"g"
"3-beta-D-glucuronosyl-3-beta-D-galactosyl-4-beta-D-galactosyl-O-beta-D-xylosylprotein"	"3-beta-D-glucuronosyl-3-beta-D-galactosyl-4-beta-D-galactosyl-O-beta-D-xylosylprotein"	"g"
"chondroitinsulfateprecursor(GalNAc-GlcA-(Gal)2-Xyl-L-Ser(protein))"	"chondroitinsulfateprecursor(GalNAc-GlcA-(Gal)2-Xyl-L-Ser(protein))"	"g"
"heparansulfate,precursor1"	"heparansulfate,precursor1"	"g"
"heparansulfate,precursor2"	"heparansulfate,precursor2"	"g"
"heparansulfate,precursor3"	"heparansulfate,precursor3"	"g"
"heparansulfate,precursor4"	"heparansulfate,precursor4"	"g"
"heparansulfate,precursor5"	"heparansulfate,precursor5"	"g"
"heparansulfate,precursor6"	"heparansulfate,precursor6"	"g"
"heparansulfate,precursor7"	"heparansulfate,precursor7"	"g"
"heparansulfate,precursor8"	"heparansulfate,precursor8"	"g"
"heparansulfate,precursor9"	"heparansulfate,precursor9"	"g"
"heparansulfate,precursor10"	"heparansulfate,precursor10"	"g"
"heparansulfate,precursor11"	"heparansulfate,precursor11"	"g"
"heparansulfate,precursor12"	"heparansulfate,precursor12"	"g"
"heparansulfate,precursor13"	"heparansulfate,precursor13"	"g"
"heparansulfate,precursor14"	"heparansulfate,precursor14"	"g"
"heparansulfate,precursor15"	"heparansulfate,precursor15"	"g"
"heparansulfateproteoglycan"	"heparansulfateproteoglycan"	"g, l"
"chondroitinsulfateA(GalNAc4S-GlcA),B(IdoA2S-GalNAc4S),andE(GalNAc4,6diS-GlcA),precursor1"	"chondroitinsulfateA(GalNAc4S-GlcA),B(IdoA2S-GalNAc4S),andE(GalNAc4,6diS-GlcA),precursor1"	"g"
"chondroitinsulfateE(GalNAc4,6diS-GlcA),precursor2"	"chondroitinsulfateE(GalNAc4,6diS-GlcA),precursor2"	"g"
"chondroitinsulfateE(GalNAc4,6diS-GlcA),precursor3"	"chondroitinsulfateE(GalNAc4,6diS-GlcA),precursor3"	"g"
"chondroitinsulfateE(GalNAc4,6diS-GlcA),precursor4"	"chondroitinsulfateE(GalNAc4,6diS-GlcA),precursor4"	"g"
"chondroitinsulfateA(GalNAc4S-GlcA)andB(IdoA2S-GalNAc4S),precursor2"	"chondroitinsulfateA(GalNAc4S-GlcA)andB(IdoA2S-GalNAc4S),precursor2"	"g"
"chondroitinsulfateA(GalNAc4S-GlcA)andB(IdoA2S-GalNAc4S),precursor3"	"chondroitinsulfateA(GalNAc4S-GlcA)andB(IdoA2S-GalNAc4S),precursor3"	"g"
"chondroitinsulfateA(GalNAc4S-GlcA)proteoglycan"	"chondroitinsulfateA(GalNAc4S-GlcA)proteoglycan"	"g, e"
"chondroitinsulfateB(IdoA2S-GalNAc4S),precursor4"	"chondroitinsulfateB(IdoA2S-GalNAc4S),precursor4"	"g"
"chondroitinsulfateB(IdoA2S-GalNAc4s),precursor5"	"chondroitinsulfateB(IdoA2S-GalNAc4s),precursor5"	"g"
"chondroitinsulfateB-dermatansulfate(IdoA2S-GalNAc4S)proteoglycan"	"chondroitinsulfateB-dermatansulfate(IdoA2S-GalNAc4S)proteoglycan"	"g"
"chondroitinsulfateC(GalNAc6S-GlcA)andD(GlcNAc6S-GlcA2S),precursor1"	"chondroitinsulfateC(GalNAc6S-GlcA)andD(GlcNAc6S-GlcA2S),precursor1"	"g"
"chondroitinsulfateC(GalNAc6S-GlcA),precursor2"	"chondroitinsulfateC(GalNAc6S-GlcA),precursor2"	"g"
"chondroitinsulfateC(GalNAc6S-GlcA),precursor3"	"chondroitinsulfateC(GalNAc6S-GlcA),precursor3"	"g"
"chondroitinsulfateC(GalNAc6S-GlcA)proteoglycan"	"chondroitinsulfateC(GalNAc6S-GlcA)proteoglycan"	"g"
"chondroitinsulfateD(GlcNAc6S-GlcA2S)precursor2"	"chondroitinsulfateD(GlcNAc6S-GlcA2S)precursor2"	"g"
"chondroitinsulfateD(GlcNAc6S-GlcA2S),precursor3"	"chondroitinsulfateD(GlcNAc6S-GlcA2S),precursor3"	"g"
"chondroitinsulfateD(GlcNAc6S-GlcA2S),precursor4"	"chondroitinsulfateD(GlcNAc6S-GlcA2S),precursor4"	"g"
"chondroitinsulfateD(GlcNAc6S-GlcA2S),precursor5"	"chondroitinsulfateD(GlcNAc6S-GlcA2S),precursor5"	"g"
"chondroitinsulfateD(GlcNAc6S-GlcA2S)proteoglycan"	"chondroitinsulfateD(GlcNAc6S-GlcA2S)proteoglycan"	"g"
"chondroitinsulfateE(GalNAc4,6diS-GlcA),precursor5a"	"chondroitinsulfateE(GalNAc4,6diS-GlcA),precursor5a"	"g"
"chondroitinsulfateE(GalNAc4,6diS-GlcA),precursor5b"	"chondroitinsulfateE(GalNAc4,6diS-GlcA),precursor5b"	"g"
"chondroitinsulfateE(GalNAc4,6diS-GlcA)proteoglycan"	"chondroitinsulfateE(GalNAc4,6diS-GlcA)proteoglycan"	"g"
"chondroitinsulfateA(GalNAc4S-GlcA),freechain"	"chondroitinsulfateA(GalNAc4S-GlcA),freechain"	"l"
"chondroitinsulfateA(GalNAc4S-GlcA),degradationproduct1"	"chondroitinsulfateA(GalNAc4S-GlcA),degradationproduct1"	"l"
"chondroitinsulfateA(GalNAc4S-GlcA),degradationproduct2"	"chondroitinsulfateA(GalNAc4S-GlcA),degradationproduct2"	"l"
"chondroitinsulfateA(GalNAc4S-GlcA),degradationproduct3"	"chondroitinsulfateA(GalNAc4S-GlcA),degradationproduct3"	"l"
"chondroitinsulfateA(GalNAc4S-GlcA),degradationproduct4"	"chondroitinsulfateA(GalNAc4S-GlcA),degradationproduct4"	"l"
"chondroitinsulfateA(GalNAc4S-GlcA),degradationproduct5"	"chondroitinsulfateA(GalNAc4S-GlcA),degradationproduct5"	"l"
"chondroitinsulfateB-dermatansulfate(IdoA2S-GalNAc4S),freechain"	"chondroitinsulfateB-dermatansulfate(IdoA2S-GalNAc4S),freechain"	"l"
"chondroitinsulfateB-dermatansulfate(IdoA2S-GalNAc4S),degradationproduct1"	"chondroitinsulfateB-dermatansulfate(IdoA2S-GalNAc4S),degradationproduct1"	"l"
"chondroitinsulfateB-dermatansulfate(IdoA2S-GalNAc4S),degradationproduct2"	"chondroitinsulfateB-dermatansulfate(IdoA2S-GalNAc4S),degradationproduct2"	"l"
"chondroitinsulfateB-dermatansulfate(IdoA2S-GalNAc4S),degradationproduct3"	"chondroitinsulfateB-dermatansulfate(IdoA2S-GalNAc4S),degradationproduct3"	"l"
"L-iduronicacid"	"L-iduronicacid"	"l, c"
"chondroitinsulfateC(GalNAc6S-GlcA),freechain"	"chondroitinsulfateC(GalNAc6S-GlcA),freechain"	"l"
"chondroitinsulfateC(GalNAc6S-GlcA),degradationproduct1"	"chondroitinsulfateC(GalNAc6S-GlcA),degradationproduct1"	"l"
"chondroitinsulfateC(GalNAc6S-GlcA),degradationproduct2"	"chondroitinsulfateC(GalNAc6S-GlcA),degradationproduct2"	"l"
"chondroitinsulfateC(GalNAc6S-GlcA),degradationproduct3"	"chondroitinsulfateC(GalNAc6S-GlcA),degradationproduct3"	"l"
"chondroitinsulfateC(GalNAc6S-GlcA),degradationproduct4"	"chondroitinsulfateC(GalNAc6S-GlcA),degradationproduct4"	"l"
"chondroitinsulfateC(GalNAc6S-GlcA),degradationproduct5"	"chondroitinsulfateC(GalNAc6S-GlcA),degradationproduct5"	"l"
"chondroitinsulfateD(GlcNAc6S-GlcA2S),freechain"	"chondroitinsulfateD(GlcNAc6S-GlcA2S),freechain"	"l"
"chondroitinsulfateD(GlcNAc6S-GlcA2S),degradationproduct1"	"chondroitinsulfateD(GlcNAc6S-GlcA2S),degradationproduct1"	"l"
"chondroitinsulfateD(GlcNAc6S-GlcA2S),degradationproduct2"	"chondroitinsulfateD(GlcNAc6S-GlcA2S),degradationproduct2"	"l"
"chondroitinsulfateD(GlcNAc6S-GlcA2S),degradationproduct3"	"chondroitinsulfateD(GlcNAc6S-GlcA2S),degradationproduct3"	"l"
"chondroitinsulfateD(GlcNAc6S-GlcA2S),degradationproduct4"	"chondroitinsulfateD(GlcNAc6S-GlcA2S),degradationproduct4"	"l"
"chondroitinsulfateD(GlcNAc6S-GlcA2S),degradationproduct5"	"chondroitinsulfateD(GlcNAc6S-GlcA2S),degradationproduct5"	"l"
"chondroitinsulfateD(GlcNAc6S-GlcA2S),degradationproduct6"	"chondroitinsulfateD(GlcNAc6S-GlcA2S),degradationproduct6"	"l"
"chondroitinsulfateE(GalNAc4,6diS-GlcA),freechain"	"chondroitinsulfateE(GalNAc4,6diS-GlcA),freechain"	"l"
"chondroitinsulfateE(GalNAc4,6diS-GlcA),degradationproduct1"	"chondroitinsulfateE(GalNAc4,6diS-GlcA),degradationproduct1"	"l"
"chondroitinsulfateE(GalNAc4,6diS-GlcA),degradationproduct3"	"chondroitinsulfateE(GalNAc4,6diS-GlcA),degradationproduct3"	"l"
"chondroitinsulfateE(GalNAc4,6diS-GlcA),degradationproduct2"	"chondroitinsulfateE(GalNAc4,6diS-GlcA),degradationproduct2"	"l"
"chondroitinsulfateE(GalNAc4,6diS-GlcA),degradationproduct4"	"chondroitinsulfateE(GalNAc4,6diS-GlcA),degradationproduct4"	"l"
"chondroitinsulfateE(GalNAc4,6diS-GlcA),degradationproduct7"	"chondroitinsulfateE(GalNAc4,6diS-GlcA),degradationproduct7"	"l"
"chondroitinsulfateE(GalNAc4,6diS-GlcA),degradationproduct5"	"chondroitinsulfateE(GalNAc4,6diS-GlcA),degradationproduct5"	"l"
"chondroitinsulfateE(GalNAc4,6diS-GlcA),degradationproduct6"	"chondroitinsulfateE(GalNAc4,6diS-GlcA),degradationproduct6"	"l"
"heparansulfate,freechain"	"heparansulfate,freechain"	"l"
"heparansulfate,degradationproduct1"	"heparansulfate,degradationproduct1"	"l"
"heparansulfate,degradationproduct2"	"heparansulfate,degradationproduct2"	"l"
"heparansulfate,degradationproduct3"	"heparansulfate,degradationproduct3"	"l"
"heparansulfate,degradationproduct4"	"heparansulfate,degradationproduct4"	"l"
"heparansulfate,degradationproduct5"	"heparansulfate,degradationproduct5"	"l"
"heparansulfate,degradationproduct6"	"heparansulfate,degradationproduct6"	"l"
"heparansulfate,degradationproduct7"	"heparansulfate,degradationproduct7"	"l"
"heparansulfate,degradationproduct8"	"heparansulfate,degradationproduct8"	"l"
"heparansulfate,degradationproduct9"	"heparansulfate,degradationproduct9"	"l"
"heparansulfate,degradationproduct10"	"heparansulfate,degradationproduct10"	"l"
"heparansulfate,degradationproduct11"	"heparansulfate,degradationproduct11"	"l"
"heparansulfate,degradationproduct12"	"heparansulfate,degradationproduct12"	"l"
"heparansulfate,degradationproduct13"	"heparansulfate,degradationproduct13"	"l"
"heparansulfate,degradationproduct14"	"heparansulfate,degradationproduct14"	"l"
"heparansulfate,degradationproduct15"	"heparansulfate,degradationproduct15"	"l"
"heparansulfate,degradationproduct16"	"heparansulfate,degradationproduct16"	"l"
"heparansulfate,degradationproduct17"	"heparansulfate,degradationproduct17"	"l"
"heparansulfate,degradationproduct18"	"heparansulfate,degradationproduct18"	"l"
"heparansulfate,degradationproduct19"	"heparansulfate,degradationproduct19"	"l"
"heparansulfate,degradationproduct20"	"heparansulfate,degradationproduct20"	"l"
"heparansulfate,degradationproduct21"	"heparansulfate,degradationproduct21"	"l"
"heparansulfate,degradationproduct22"	"heparansulfate,degradationproduct22"	"l"
"heparansulfate,degradationproduct23"	"heparansulfate,degradationproduct23"	"l"
"heparansulfate,degradationproduct24"	"heparansulfate,degradationproduct24"	"l"
"heparansulfate,degradationproduct25"	"heparansulfate,degradationproduct25"	"l"
"hyaluronate"	"hyaluronate"	"l, e"
"hyaluronandegradationproduct1"	"hyaluronandegradationproduct1"	"l"
"hyaluronanbiosynthesis,precursor1"	"hyaluronanbiosynthesis,precursor1"	"l, e"
"keratansulfateIbiosynthesis,precursor1"	"keratansulfateIbiosynthesis,precursor1"	"g"
"keratansulfateIbiosynthesis,precursor2"	"keratansulfateIbiosynthesis,precursor2"	"g"
"keratansulfateIbiosynthesis,precursor3"	"keratansulfateIbiosynthesis,precursor3"	"g"
"keratansulfateIbiosynthesis,precursor4"	"keratansulfateIbiosynthesis,precursor4"	"g"
"keratansulfateIbiosynthesis,precursor5"	"keratansulfateIbiosynthesis,precursor5"	"g"
"keratansulfateIbiosynthesis,precursor6"	"keratansulfateIbiosynthesis,precursor6"	"g"
"keratansulfateIbiosynthesis,precursor7"	"keratansulfateIbiosynthesis,precursor7"	"g"
"keratansulfateIbiosynthesis,precursor8"	"keratansulfateIbiosynthesis,precursor8"	"g"
"keratansulfateIbiosynthesis,precursor9"	"keratansulfateIbiosynthesis,precursor9"	"g"
"keratansulfateIbiosynthesis,precursor10"	"keratansulfateIbiosynthesis,precursor10"	"g"
"keratansulfateIbiosynthesis,precursor11"	"keratansulfateIbiosynthesis,precursor11"	"g"
"keratansulfateIbiosynthesis,precursor12"	"keratansulfateIbiosynthesis,precursor12"	"g"
"keratansulfateIbiosynthesis,precursor13"	"keratansulfateIbiosynthesis,precursor13"	"g"
"keratansulfateIbiosynthesis,precursor14"	"keratansulfateIbiosynthesis,precursor14"	"g"
"keratansulfateIbiosynthesis,precursor15"	"keratansulfateIbiosynthesis,precursor15"	"g"
"keratansulfateIbiosynthesis,precursor16"	"keratansulfateIbiosynthesis,precursor16"	"g"
"keratansulfateIbiosynthesis,precursor17"	"keratansulfateIbiosynthesis,precursor17"	"g"
"keratansulfateIbiosynthesis,precursor18"	"keratansulfateIbiosynthesis,precursor18"	"g"
"keratansulfateIbiosynthesis,precursor19"	"keratansulfateIbiosynthesis,precursor19"	"g"
"keratansulfateIbiosynthesis,precursor20"	"keratansulfateIbiosynthesis,precursor20"	"g"
"keratansulfateIbiosynthesis,precursor21"	"keratansulfateIbiosynthesis,precursor21"	"g"
"keratansulfateIbiosynthesis,precursor22"	"keratansulfateIbiosynthesis,precursor22"	"g"
"keratansulfateIbiosynthesis,precursor23"	"keratansulfateIbiosynthesis,precursor23"	"g"
"keratansulfateIbiosynthesis,precursor24"	"keratansulfateIbiosynthesis,precursor24"	"g"
"keratansulfateIbiosynthesis,precursor25"	"keratansulfateIbiosynthesis,precursor25"	"g"
"keratansulfateIbiosynthesis,precursor26"	"keratansulfateIbiosynthesis,precursor26"	"g"
"keratansulfateIbiosynthesis,precursor27"	"keratansulfateIbiosynthesis,precursor27"	"g"
"keratansulfateIbiosynthesis,precursor28"	"keratansulfateIbiosynthesis,precursor28"	"g"
"keratansulfateIbiosynthesis,precursor29"	"keratansulfateIbiosynthesis,precursor29"	"g"
"keratansulfateIbiosynthesis,precursor30"	"keratansulfateIbiosynthesis,precursor30"	"g"
"keratansulfateIbiosynthesis,precursor31"	"keratansulfateIbiosynthesis,precursor31"	"g"
"keratansulfateIbiosynthesis,precursor32"	"keratansulfateIbiosynthesis,precursor32"	"g"
"keratansulfateIbiosynthesis,precursor33"	"keratansulfateIbiosynthesis,precursor33"	"g"
"keratansulfateIbiosynthesis,precursor34"	"keratansulfateIbiosynthesis,precursor34"	"g"
"keratansulfateIbiosynthesis,precursor35"	"keratansulfateIbiosynthesis,precursor35"	"g"
"keratansulfateIbiosynthesis,precursor36"	"keratansulfateIbiosynthesis,precursor36"	"g"
"keratansulfateI"	"keratansulfateI"	"g, e, l"
"keratansulfateIIbiosynthesis,precursor1"	"keratansulfateIIbiosynthesis,precursor1"	"g"
"keratansulfateIIbiosynthesis,precursor2"	"keratansulfateIIbiosynthesis,precursor2"	"g"
"keratansulfateIIbiosynthesis,precursor3"	"keratansulfateIIbiosynthesis,precursor3"	"g"
"keratansulfateIIbiosynthesis,precursor4"	"keratansulfateIIbiosynthesis,precursor4"	"g"
"keratansulfateIIbiosynthesis,precursor5"	"keratansulfateIIbiosynthesis,precursor5"	"g"
"keratansulfateIIbiosynthesis,precursor6"	"keratansulfateIIbiosynthesis,precursor6"	"g"
"keratansulfateIIbiosynthesis,precursor7"	"keratansulfateIIbiosynthesis,precursor7"	"g"
"keratansulfateIIbiosynthesis,precursor8"	"keratansulfateIIbiosynthesis,precursor8"	"g"
"keratansulfateIIbiosynthesis,precursor9"	"keratansulfateIIbiosynthesis,precursor9"	"g"
"keratansulfateIIbiosynthesis,precursor10"	"keratansulfateIIbiosynthesis,precursor10"	"g"
"keratansulfateII(core2-linked)"	"keratansulfateII(core2-linked)"	"g, l"
"core4"	"core4"	"g"
"keratansulfateII(core4-linked),biosynthesis,precursor1"	"keratansulfateII(core4-linked),biosynthesis,precursor1"	"g"
"keratansulfateII(core4-linked),biosynthesis,precursor2"	"keratansulfateII(core4-linked),biosynthesis,precursor2"	"g"
"keratansulfateII(core4-linked),biosynthesis,precursor3"	"keratansulfateII(core4-linked),biosynthesis,precursor3"	"g"
"keratansulfateII(core4-linked),biosynthesis,precursor4"	"keratansulfateII(core4-linked),biosynthesis,precursor4"	"g"
"keratansulfateII(core4-linked),biosynthesis,precursor5"	"keratansulfateII(core4-linked),biosynthesis,precursor5"	"g"
"keratansulfateII(core4-linked),biosynthesis,precursor6"	"keratansulfateII(core4-linked),biosynthesis,precursor6"	"g"
"keratansulfateII(core4-linked),biosynthesis,precursor7"	"keratansulfateII(core4-linked),biosynthesis,precursor7"	"g"
"keratansulfateII(core4-linked),biosynthesis,precursor8"	"keratansulfateII(core4-linked),biosynthesis,precursor8"	"g"
"keratansulfateII(core4-linked),biosynthesis,precursor9"	"keratansulfateII(core4-linked),biosynthesis,precursor9"	"g"
"keratansulfateII(core4-linked),biosynthesis,precursor10"	"keratansulfateII(core4-linked),biosynthesis,precursor10"	"g"
"keratansulfateII(core4-linked)"	"keratansulfateII(core4-linked)"	"g, l"
"keratansulfateI,degradationproduct1"	"keratansulfateI,degradationproduct1"	"e, l"
"keratansulfateI,degradationproduct2"	"keratansulfateI,degradationproduct2"	"l"
"keratansulfateI,degradationproduct3"	"keratansulfateI,degradationproduct3"	"l"
"keratansulfateI,degradationproduct4"	"keratansulfateI,degradationproduct4"	"l"
"keratansulfateI,degradationproduct5"	"keratansulfateI,degradationproduct5"	"l"
"keratansulfateI,degradationproduct6"	"keratansulfateI,degradationproduct6"	"l"
"keratansulfateI,degradationproduct7"	"keratansulfateI,degradationproduct7"	"l"
"keratansulfateI,degradationproduct8"	"keratansulfateI,degradationproduct8"	"l"
"keratansulfateI,degradationproduct9"	"keratansulfateI,degradationproduct9"	"l"
"keratansulfateI,degradationproduct10"	"keratansulfateI,degradationproduct10"	"l"
"keratansulfateI,degradationproduct11"	"keratansulfateI,degradationproduct11"	"l"
"keratansulfateI,degradationproduct12"	"keratansulfateI,degradationproduct12"	"l"
"keratansulfateI,degradationproduct13"	"keratansulfateI,degradationproduct13"	"l"
"keratansulfateI,degradationproduct14"	"keratansulfateI,degradationproduct14"	"l"
"keratansulfateI,degradationproduct15"	"keratansulfateI,degradationproduct15"	"l"
"keratansulfateI,degradationproduct16"	"keratansulfateI,degradationproduct16"	"l"
"keratansulfateI,degradationproduct17"	"keratansulfateI,degradationproduct17"	"l"
"keratansulfateI,degradationproduct18"	"keratansulfateI,degradationproduct18"	"l"
"keratansulfateI,degradationproduct19"	"keratansulfateI,degradationproduct19"	"l"
"keratansulfateI,degradationproduct20"	"keratansulfateI,degradationproduct20"	"l"
"keratansulfateI,degradationproduct21"	"keratansulfateI,degradationproduct21"	"l"
"keratansulfateI,degradationproduct22"	"keratansulfateI,degradationproduct22"	"l"
"keratansulfateI,degradationproduct23"	"keratansulfateI,degradationproduct23"	"l"
"keratansulfateI,degradationproduct24"	"keratansulfateI,degradationproduct24"	"l"
"keratansulfateI,degradationproduct25"	"keratansulfateI,degradationproduct25"	"l"
"keratansulfateI,degradationproduct26"	"keratansulfateI,degradationproduct26"	"l"
"keratansulfateI,degradationproduct27"	"keratansulfateI,degradationproduct27"	"l"
"keratansulfateI,degradationproduct28"	"keratansulfateI,degradationproduct28"	"l"
"keratansulfateI,degradationproduct29"	"keratansulfateI,degradationproduct29"	"l"
"keratansulfateI,degradationproduct30"	"keratansulfateI,degradationproduct30"	"l"
"keratansulfateI,degradationproduct31"	"keratansulfateI,degradationproduct31"	"l"
"keratansulfateI,degradationproduct32"	"keratansulfateI,degradationproduct32"	"l"
"keratansulfateI,degradationproduct33"	"keratansulfateI,degradationproduct33"	"l"
"keratansulfateI,degradationproduct34"	"keratansulfateI,degradationproduct34"	"l"
"keratansulfateI,degradationproduct35"	"keratansulfateI,degradationproduct35"	"l"
"keratansulfateI,degradationproduct36"	"keratansulfateI,degradationproduct36"	"l"
"keratansulfateI,degradationproduct37"	"keratansulfateI,degradationproduct37"	"l"
"keratansulfateI,degradationproduct38"	"keratansulfateI,degradationproduct38"	"l"
"keratansulfateI,degradationproduct39"	"keratansulfateI,degradationproduct39"	"l"
"keratansulfateI,degradationproduct40"	"keratansulfateI,degradationproduct40"	"l"
"keratansulfateI,degradationproduct41"	"keratansulfateI,degradationproduct41"	"l"
"keratansulfateII(core2-linked),degradationproduct1"	"keratansulfateII(core2-linked),degradationproduct1"	"l"
"keratansulfateII(core2-linked),degradationproduct2"	"keratansulfateII(core2-linked),degradationproduct2"	"l"
"keratansulfateII(core2-linked),degradationproduct3"	"keratansulfateII(core2-linked),degradationproduct3"	"l"
"keratansulfateII(core2-linked),degradationproduct4"	"keratansulfateII(core2-linked),degradationproduct4"	"l"
"keratansulfateII(core2-linked),degradationproduct5"	"keratansulfateII(core2-linked),degradationproduct5"	"l"
"keratansulfateII(core2-linked),degradationproduct6"	"keratansulfateII(core2-linked),degradationproduct6"	"l"
"keratansulfateII(core2-linked),degradationproduct8"	"keratansulfateII(core2-linked),degradationproduct8"	"l"
"keratansulfateII(core2-linked),degradationproduct7"	"keratansulfateII(core2-linked),degradationproduct7"	"l"
"keratansulfateII(core2-linked),degradationproduct9"	"keratansulfateII(core2-linked),degradationproduct9"	"l"
"F1alpha"	"F1alpha"	"l"
"core6"	"core6"	"l"
"keratansulfateII(core4-linked),degradationproduct1"	"keratansulfateII(core4-linked),degradationproduct1"	"l"
"keratansulfateII(core4-linked),degradationproduct2"	"keratansulfateII(core4-linked),degradationproduct2"	"l"
"keratansulfateII(core4-linked),degradationproduct3"	"keratansulfateII(core4-linked),degradationproduct3"	"l"
"keratansulfateII(core4-linked),degradationproduct4"	"keratansulfateII(core4-linked),degradationproduct4"	"l"
"7alpha-hydroxycholesterol"	"7alpha-hydroxycholesterol"	"r"
"7alpha-hydroxycholest-4-en-3-one"	"7alpha-hydroxycholest-4-en-3-one"	"r"
"5beta-cholestan-3alpha,7alpha,12alpha-triol"	"5beta-cholestan-3alpha,7alpha,12alpha-triol"	"c, m"
"5beta-cholestane-3alpha,7alpha,12alpha,26-tetrol"	"5beta-cholestane-3alpha,7alpha,12alpha,26-tetrol"	"c, m"
"3alpha,7alpha,12alpha-trihydroxy-5beta-cholestan-26-al"	"3alpha,7alpha,12alpha-trihydroxy-5beta-cholestan-26-al"	"c, m"
"3alpha,7alpha,12alpha-trihydroxy-5beta-cholestanate"	"3alpha,7alpha,12alpha-trihydroxy-5beta-cholestanate"	"c, m, r, p"
"25(R)THCA-CoA"	"25(R)THCA-CoA"	"r, p, c, m"
"25(S)THCA-CoA"	"25(S)THCA-CoA"	"p, m"
"choloyl-CoA"	"choloyl-CoA"	"p, m, c, r"
"cholate"	"cholate"	"c, m, p, r, e"
"5beta-cholestane-3alpha,7alpha-diol"	"5beta-cholestane-3alpha,7alpha-diol"	"c, m"
"5beta-cholestane-3alpha,7alpha,26-triol"	"5beta-cholestane-3alpha,7alpha,26-triol"	"c, m"
"3alpha,7alpha-dihydroxy-5beta-cholestan-26-al"	"3alpha,7alpha-dihydroxy-5beta-cholestan-26-al"	"c, m"
"5beta-cholestane-3alpha,7alpha,27-triol"	"5beta-cholestane-3alpha,7alpha,27-triol"	"m"
"3alpha,7alpha-dihydroxy-5beta-cholestan-27-al"	"3alpha,7alpha-dihydroxy-5beta-cholestan-27-al"	"m"
"3alpha,7alpha-dihydroxy-5beta-cholestanate"	"3alpha,7alpha-dihydroxy-5beta-cholestanate"	"m, c, r, p"
"25(R)DHCA-CoA"	"25(R)DHCA-CoA"	"c, r, p"
"25(S)DHCA-CoA"	"25(S)DHCA-CoA"	"p"
"3alpha,7alpha-dihydroxy-5beta-cholest-24-enoyl-CoA"	"3alpha,7alpha-dihydroxy-5beta-cholest-24-enoyl-CoA"	"p"
"(24R,25R)3alpha,7alpha,24-trihydroxy-5beta-cholestanoyl-CoA"	"(24R,25R)3alpha,7alpha,24-trihydroxy-5beta-cholestanoyl-CoA"	"p"
"3alpha,7alpha-dihydroxy-24-oxo-5beta-cholestanoylcoa"	"3alpha,7alpha-dihydroxy-24-oxo-5beta-cholestanoylcoa"	"p"
"chenodeoxycholoyl-CoA"	"chenodeoxycholoyl-CoA"	"p, c, r"
"chenodiol"	"chenodiol"	"p, c, r, e"
"24-hydroxycholesterol"	"24-hydroxycholesterol"	"c"
"cholest-5-ene-3beta,7alpha,24(S)-triol"	"cholest-5-ene-3beta,7alpha,24(S)-triol"	"c"
"4-cholesten-7alpha,24(S)-diol-3-one"	"4-cholesten-7alpha,24(S)-diol-3-one"	"c"
"5beta-cholestan-3alpha,7alpha,12alpha,24(S)-tetrol"	"5beta-cholestan-3alpha,7alpha,12alpha,24(S)-tetrol"	"m"
"5beta-cholestan-3alpha,7alpha,12alpha,24(S),27-pentol"	"5beta-cholestan-3alpha,7alpha,12alpha,24(S),27-pentol"	"m"
"5beta-cholestan-3alpha,7alpha,24(S)-triol"	"5beta-cholestan-3alpha,7alpha,24(S)-triol"	"m"
"5beta-cholestan-3alpha,7alpha,24(S),27-tetrol"	"5beta-cholestan-3alpha,7alpha,24(S),27-tetrol"	"m"
"3alpha,7alpha,12alpha,24(S)-tetrahydroxy-5beta-cholestan-27-al"	"3alpha,7alpha,12alpha,24(S)-tetrahydroxy-5beta-cholestan-27-al"	"m"
"3alpha,7alpha,24(S)-trihydroxy-5beta-cholestan-27-al"	"3alpha,7alpha,24(S)-trihydroxy-5beta-cholestan-27-al"	"m"
"tetraHCA"	"tetraHCA"	"m, c"
"3,7,24THCA"	"3,7,24THCA"	"m, c, p"
"25(R)TetraHCA-CoA"	"25(R)TetraHCA-CoA"	"c, p"
"3,7,24THCA-CoA"	"3,7,24THCA-CoA"	"c, p"
"27-hydroxycholesterol"	"27-hydroxycholesterol"	"m, c"
"cholest-5-ene-3beta,7alpha,27-triol"	"cholest-5-ene-3beta,7alpha,27-triol"	"c, m"
"4-cholesten-7alpha,27-diol-3-one"	"4-cholesten-7alpha,27-diol-3-one"	"c"
"25-hydroxycholesterol"	"25-hydroxycholesterol"	"r"
"cholest-5-ene-3beta,7alpha,25-triol"	"cholest-5-ene-3beta,7alpha,25-triol"	"r"
"26-hydroxycholesterol"	"26-hydroxycholesterol"	"m, r, c"
"3beta-hydroxy-5-cholestenal"	"3beta-hydroxy-5-cholestenal"	"m"
"3beta-hydroxy-5-cholestene-27-oate"	"3beta-hydroxy-5-cholestene-27-oate"	"m"
"3beta,7alpha-dihydroxy-5-cholestenoate"	"3beta,7alpha-dihydroxy-5-cholestenoate"	"m"
"7alpha-hydroxy-3-oxo-4-cholestenoicacid"	"7alpha-hydroxy-3-oxo-4-cholestenoicacid"	"m"
"5beta-cholestane-3alpha,7alpha,12alpha,27-tetraol"	"5beta-cholestane-3alpha,7alpha,12alpha,27-tetraol"	"m, c"
"5beta-cholestane-3alpha,7alpha,12alpha,27,27-pentaol"	"5beta-cholestane-3alpha,7alpha,12alpha,27,27-pentaol"	"c, m"
"3alpha,7alpha,12alpha-trihydroxy-5beta-cholestan-27-al"	"3alpha,7alpha,12alpha-trihydroxy-5beta-cholestan-27-al"	"m"
"5beta-cholestane-3alpha,7alpha,12alpha,25-tetrol"	"5beta-cholestane-3alpha,7alpha,12alpha,25-tetrol"	"r"
"5beta-cholestane-3alpha,7alpha,12alpha,24s,25-pentol"	"5beta-cholestane-3alpha,7alpha,12alpha,24s,25-pentol"	"r"
"3alpha,7alpha,12alpha,25-tetrahydroxy-5beta-cholestane-24-one"	"3alpha,7alpha,12alpha,25-tetrahydroxy-5beta-cholestane-24-one"	"r"
"3alpha,12alpha-dihydroxy-5beta-cholanate"	"3alpha,12alpha-dihydroxy-5beta-cholanate"	"c, r"
"deoxycholoyl-CoA"	"deoxycholoyl-CoA"	"c, r"
"hypotaurine"	"hypotaurine"	"c"
"cysteamine"	"cysteamine"	"c"
"taurine"	"taurine"	"c, e, p"
"Na"	"Na"	"e, c, p, g"
"glycocholate"	"glycocholate"	"e, c"
"taurocholate"	"taurocholate"	"e, c"
"taurochenodeoxycholate"	"taurochenodeoxycholate"	"e, c"
"glycochenodeoxycholate"	"glycochenodeoxycholate"	"e, c"
"glutathionyl-leukotrieneC4"	"glutathionyl-leukotrieneC4"	"c, e"
"S-glutathionyl-2-4-dinitrobenzene"	"S-glutathionyl-2-4-dinitrobenzene"	"c, e"
"S-glutathionyl-ethacrynicacid"	"S-glutathionyl-ethacrynicacid"	"c, e"
"bilirubin-bisglucuronoside"	"bilirubin-bisglucuronoside"	"r, e, c"
"bilirubin-monoglucuronoside"	"bilirubin-monoglucuronoside"	"r, e, c"
"typeIHglycolipid"	"typeIHglycolipid"	"g"
"lactoneotetraosylceramide"	"lactoneotetraosylceramide"	"g"
"typeIIHglycolipid"	"typeIIHglycolipid"	"g"
"galacgalfuc12gal14acglcgalglusideheparansulfate"	"galacgalfuc12gal14acglcgalglusideheparansulfate"	"g"
"glycolipid"	"glycolipid"	"g"
"galacgalfucgalacglcgal14acglcgalglusideheparansulfate"	"galacgalfucgalacglcgal14acglcgalglusideheparansulfate"	"g"
"fucgalacgalfucgalacglcgal14acglcgalglusideheparansulfate"	"fucgalacgalfucgalacglcgal14acglcgalglusideheparansulfate"	"g"
"fucfucgalacglcgalacglcgal14acglcgalglusideheparansulfate"	"fucfucgalacglcgalacglcgal14acglcgalglusideheparansulfate"	"g"
"fucgalacglc13galacglcgal14acglcgalglusideheparansulfate"	"fucgalacglc13galacglcgal14acglcgalglusideheparansulfate"	"g"
"fucfucgalacglc13galacglcgal14acglcgalglusideheparansulfate"	"fucfucgalacglc13galacglcgal14acglcgalglusideheparansulfate"	"g"
"fucfucfucgalacglc13galacglcgal14acglcgalglusideheparansulfate"	"fucfucfucgalacglc13galacglcgal14acglcgalglusideheparansulfate"	"g"
"acngalacglcgalglusideheparansulfate"	"acngalacglcgalglusideheparansulfate"	"g"
"lacto-N-fucopentaosyl-III-ceramide"	"lacto-N-fucopentaosyl-III-ceramide"	"g"
"fucfucgalacglcgal14acglcgalglusideheparansulfate"	"fucfucgalacglcgal14acglcgalglusideheparansulfate"	"g"
"fucfucfucgalacglcgal14acglcgalglusideheparansulfate"	"fucfucfucgalacglcgal14acglcgalglusideheparansulfate"	"g"
"fucfuc132galacglcgal14acglcgalglusideheparansulfate"	"fucfuc132galacglcgal14acglcgalglusideheparansulfate"	"g"
"ferricytochromeB5"	"ferricytochromeB5"	"c"
"ferrocytochromeB5"	"ferrocytochromeB5"	"c"
"quinolinate"	"quinolinate"	"c"
"nicotinateribonucleotide"	"nicotinateribonucleotide"	"c, n"
"nicotinateD-ribonucleoside"	"nicotinateD-ribonucleoside"	"c"
"deamido-NAD"	"deamido-NAD"	"c, n"
"nicotinamideD-ribonucleotide"	"nicotinamideD-ribonucleotide"	"c, m, n"
"nicotinamide"	"nicotinamide"	"c, e"
"nicotinamideribonucleoside"	"nicotinamideribonucleoside"	"c"
"nicotinate"	"nicotinate"	"c"
"ADP-ribose-2-phosphate"	"ADP-ribose-2-phosphate"	"c, e"
"1-methylnicotinamide"	"1-methylnicotinamide"	"c"
"dephospho-CoA"	"dephospho-CoA"	"c, m, l"
"apo-[ACP]"	"apo-[ACP]"	"c"
"pantetheine"	"pantetheine"	"c, m"
"phosphopantetheine"	"phosphopantetheine"	"c, m"
"N-pantothenoylcysteine"	"N-pantothenoylcysteine"	"c, m"
"pantothenate"	"pantothenate"	"c, e"
"D-4-phosphopantothenate"	"D-4-phosphopantothenate"	"c"
"(R)-4-phosphopantothenoyl-cysteine"	"(R)-4-phosphopantothenoyl-cysteine"	"c, m"
"inositol-1-phosphate"	"inositol-1-phosphate"	"c, n"
"1-phosphatidyl-1D-myo-inositol-3-phosphate"	"1-phosphatidyl-1D-myo-inositol-3-phosphate"	"c, r"
"1-phosphatidyl-myo-inositol-3,5-bisphosphate"	"1-phosphatidyl-myo-inositol-3,5-bisphosphate"	"c, g, r"
"1-phosphatidyl-1D-myo-inositol-4-phosphate"	"1-phosphatidyl-1D-myo-inositol-4-phosphate"	"c, n"
"1-phosphatidyl-1D-myo-inositol-3,4-bisphosphate"	"1-phosphatidyl-1D-myo-inositol-3,4-bisphosphate"	"c"
"phosphatidylinositol-4,5-bisphosphate"	"phosphatidylinositol-4,5-bisphosphate"	"c, n"
"1-phosphatidyl-1D-myo-inositol-5-phosphate"	"1-phosphatidyl-1D-myo-inositol-5-phosphate"	"c, g, r"
"phosphatidylinositol-3,4,5-trisphosphate"	"phosphatidylinositol-3,4,5-trisphosphate"	"c, n"
"phosphatidylinositol-3,5-bisphosphate"	"phosphatidylinositol-3,5-bisphosphate"	"c, r"
"D-myo-inositol-1,4,5-trisphosphate"	"D-myo-inositol-1,4,5-trisphosphate"	"c, n"
"1D-myo-inositol-1,4-bisphosphate"	"1D-myo-inositol-1,4-bisphosphate"	"c, n"
"1D-myo-inositol-4-phosphate"	"1D-myo-inositol-4-phosphate"	"c"
"1D-myo-inositol-1,3,4,5-tetrakisphosphate"	"1D-myo-inositol-1,3,4,5-tetrakisphosphate"	"c, n"
"1D-myo-inositol-1,3,4-trisphosphate"	"1D-myo-inositol-1,3,4-trisphosphate"	"c"
"1D-myo-inositol-1,3,4,6-tetrakisphosphate"	"1D-myo-inositol-1,3,4,6-tetrakisphosphate"	"c, n"
"1D-myo-inositol-1,3,4,5,6-pentakisphosphate"	"1D-myo-inositol-1,3,4,5,6-pentakisphosphate"	"c, n"
"1D-myo-inositol-3,4-bisphosphate"	"1D-myo-inositol-3,4-bisphosphate"	"c"
"1D-myo-inositol-3-phosphate"	"1D-myo-inositol-3-phosphate"	"c"
"1D-myo-inositol-1,4,5,6-tetrakisphosphate"	"1D-myo-inositol-1,4,5,6-tetrakisphosphate"	"c, n"
"1D-myo-inositol-3,4,5,6-tetrakisphosphate"	"1D-myo-inositol-3,4,5,6-tetrakisphosphate"	"c"
"myo-inositol-hexakisphosphate"	"myo-inositol-hexakisphosphate"	"c, n"
"5-pp-inspP5"	"5-pp-inspP5"	"c, n"
"1D-myo-inositol-bisdiphosphate-tetrakisphosphate"	"1D-myo-inositol-bisdiphosphate-tetrakisphosphate"	"c, n"
"5,10-methenyl-THF"	"5,10-methenyl-THF"	"m, c"
"folate"	"folate"	"c, m, e"
"5-formyl-THF"	"5-formyl-THF"	"m, c, e"
"cPMP"	"cPMP"	"c"
"molybdopterin"	"molybdopterin"	"c"
"adenylatedmolybdopterin"	"adenylatedmolybdopterin"	"c"
"10-formyl-THF-glu(5)"	"10-formyl-THF-glu(5)"	"c, m, l, e"
"10-formyl-THF-glu(6)"	"10-formyl-THF-glu(6)"	"c, m, l, e"
"10-formyl-THF-glu(7)"	"10-formyl-THF-glu(7)"	"c, m, e, l"
"pentaglutamyl-folate(DHF)"	"pentaglutamyl-folate(DHF)"	"c, m, e, l"
"hexaglutamyl-folate(DHF)"	"hexaglutamyl-folate(DHF)"	"c, m, e, l"
"heptaglutamyl-folate(DHF)"	"heptaglutamyl-folate(DHF)"	"c, m, e, l"
"pentaglutamyl-folate(THF)"	"pentaglutamyl-folate(THF)"	"c, m, e, l"
"hexaglutamyl-folate(THF)"	"hexaglutamyl-folate(THF)"	"c, m, e, l"
"heptaglutamyl-folate(THF)"	"heptaglutamyl-folate(THF)"	"c, m, e, l"
"biocytin"	"biocytin"	"c, n, e"
"biotin"	"biotin"	"c, n, e"
"biotinyl-5-AMP"	"biotinyl-5-AMP"	"c"
"apoC-lys"	"apoC-lys"	"c"
"apoC-lys_btn"	"apoC-lys_btn"	"c"
"carboxybiotin-carboxyl-carrier"	"carboxybiotin-carboxyl-carrier"	"c"
"6-[(1S,2R)-1,2-dihydroxy-3-triphosphooxypropyl]-7,8-dihydropterin"	"6-[(1S,2R)-1,2-dihydroxy-3-triphosphooxypropyl]-7,8-dihydropterin"	"c, n"
"6-pyruvoyltetrahydropterin"	"6-pyruvoyltetrahydropterin"	"c, n"
"triphosphate"	"triphosphate"	"c, n, m"
"6-lactoyl-5,6,7,8-tetrahydropterin"	"6-lactoyl-5,6,7,8-tetrahydropterin"	"c"
"formamidopyrimidinenucleosidetriphosphate"	"formamidopyrimidinenucleosidetriphosphate"	"c, n"
"O2-4a-cyclic-tetrahydrobiopterin"	"O2-4a-cyclic-tetrahydrobiopterin"	"c, n"
"quinonoiddihydrobiopterin"	"quinonoiddihydrobiopterin"	"c, n"
"dihydroneopterin"	"dihydroneopterin"	"c"
"2,5-diamino-6-(5-triphosphoryl-3,4-trihydroxy-2-oxopentyl)-amino-4-oxopyrimidine"	"2,5-diamino-6-(5-triphosphoryl-3,4-trihydroxy-2-oxopentyl)-amino-4-oxopyrimidine"	"c, n"
"2,5-diaminopyrimidinenucleosidetriphosphate"	"2,5-diaminopyrimidinenucleosidetriphosphate"	"c, n"
"dehydroascorbicacid"	"dehydroascorbicacid"	"c, e"
"ascorbate"	"ascorbate"	"c, e"
"lipoyllysine"	"lipoyllysine"	"c"
"D-glucurono-6,3-lactone"	"D-glucurono-6,3-lactone"	"c"
"D-glucarate"	"D-glucarate"	"c"
"Fe2"	"Fe2"	"e, m, c"
"Fe3"	"Fe3"	"e, c"
"porphobilinogen"	"porphobilinogen"	"c"
"hydroxymethylbilane"	"hydroxymethylbilane"	"c"
"uroporphyrinogenIII"	"uroporphyrinogenIII"	"c"
"coproporphyrinogenIII"	"coproporphyrinogenIII"	"c"
"protoporphyrinogenIX"	"protoporphyrinogenIX"	"c, m"
"protoporphyrin"	"protoporphyrin"	"m, c"
"heme"	"heme"	"m, c, e"
"cytochrome-C"	"cytochrome-C"	"m"
"hemoglobin"	"hemoglobin"	"c"
"biliverdin"	"biliverdin"	"c"
"globin"	"globin"	"c"
"bilirubin"	"bilirubin"	"r, e, c"
"uroporphyrinogenI"	"uroporphyrinogenI"	"c"
"coproporphyrinogenI"	"coproporphyrinogenI"	"c"
"retinol"	"retinol"	"c, r"
"retinal"	"retinal"	"c, r"
"1-lysolecithinpool"	"1-lysolecithinpool"	"c"
"retinyl-ester"	"retinyl-ester"	"c"
"fattyacid-retinolpool"	"fattyacid-retinolpool"	"c"
"11-cis-retinol"	"11-cis-retinol"	"c"
"11-cis-retinal"	"11-cis-retinal"	"c"
"11-cis-retinyl-palmitate"	"11-cis-retinyl-palmitate"	"c"
"anhydroretinol"	"anhydroretinol"	"c"
"4-hydroxyvitaminA1"	"4-hydroxyvitaminA1"	"c, r"
"9-cis-retinol"	"9-cis-retinol"	"c"
"9-cis-retinal"	"9-cis-retinal"	"c, r"
"13-cis-retinol"	"13-cis-retinol"	"c"
"retinoate"	"retinoate"	"c, r, e"
"9-cis-retinoate"	"9-cis-retinoate"	"r, c"
"18-hydroxy-all-trans-retinoate"	"18-hydroxy-all-trans-retinoate"	"c, r"
"4-oxo-9-cis-retinoate"	"4-oxo-9-cis-retinoate"	"c, r"
"9-cis-4-oxo-13,14-dihydro-retinoate"	"9-cis-4-oxo-13,14-dihydro-retinoate"	"c"
"13-cis-retinal"	"13-cis-retinal"	"r, c"
"13-cis-retinoate"	"13-cis-retinoate"	"c, r"
"4-oxo-13-cis-retinoate"	"4-oxo-13-cis-retinoate"	"c, r"
"5,6-epoxy-13-cis-retinoate"	"5,6-epoxy-13-cis-retinoate"	"c, r"
"5,8-epoxy-13-cis-retinoate"	"5,8-epoxy-13-cis-retinoate"	"c"
"4-hydroxy-all-trans-retinoate"	"4-hydroxy-all-trans-retinoate"	"c, r"
"4-oxo-all-trans-retinoate"	"4-oxo-all-trans-retinoate"	"c, r"
"riboflavin"	"riboflavin"	"c"
"FMN"	"FMN"	"c"
"5-hydroxy-L-tryptophan"	"5-hydroxy-L-tryptophan"	"c, e"
"hydroxide"	"hydroxide"	"c, e"
"6-hydroxymelatonin-sulfate"	"6-hydroxymelatonin-sulfate"	"c"
"serotonin"	"serotonin"	"c, e"
"5-hydroxyindoleacetaldehyde"	"5-hydroxyindoleacetaldehyde"	"c"
"5-hydroxyindoleacetate"	"5-hydroxyindoleacetate"	"c"
"5-hydroxytryptophol"	"5-hydroxytryptophol"	"c"
"5-methoxytryptophol"	"5-methoxytryptophol"	"c"
"thiamin"	"thiamin"	"m, c, e"
"thiamin-PPP"	"thiamin-PPP"	"c, e"
"thiamin-P"	"thiamin-P"	"c, e"
"2-(alpha-hydroxyethyl)thiamine-diphosphate"	"2-(alpha-hydroxyethyl)thiamine-diphosphate"	"c"
"cob(II)alamin"	"cob(II)alamin"	"m"
"cob(I)alamin"	"cob(I)alamin"	"m"
"cobamide-coenzyme"	"cobamide-coenzyme"	"m"
"pyridoxal"	"pyridoxal"	"c"
"pyridoxine"	"pyridoxine"	"c"
"pyridoxamine"	"pyridoxamine"	"c"
"pyridoxamine-phosphate"	"pyridoxamine-phosphate"	"c"
"vitaminD3"	"vitaminD3"	"c, m"
"calcidiol"	"calcidiol"	"c, m"
"calcitriol"	"calcitriol"	"c"
"23s,25-dihydroxyvitaminD3"	"23s,25-dihydroxyvitaminD3"	"c, m"
"23S,25,26-trihydroxyvitaminD3"	"23S,25,26-trihydroxyvitaminD3"	"c, m"
"25-hydroxyvitaminD3-26,23-lactol"	"25-hydroxyvitaminD3-26,23-lactol"	"c, m"
"25-hydroxyvitaminD3-26,23-lactone"	"25-hydroxyvitaminD3-26,23-lactone"	"c, m"
"calcitetrol"	"calcitetrol"	"c, m"
"24-oxo-1alpha,25-dihydroxyvitaminD3"	"24-oxo-1alpha,25-dihydroxyvitaminD3"	"c, m"
"24-oxo-1alpha,23,25-trihydroxyvitaminD3"	"24-oxo-1alpha,23,25-trihydroxyvitaminD3"	"c, m"
"vitaminD2"	"vitaminD2"	"m"
"25-hydroxyvitaminD2"	"25-hydroxyvitaminD2"	"m"
"13-carboxy-alpha-tocotrienol"	"13-carboxy-alpha-tocotrienol"	"m"
"11-carboxy-alpha-tocotrienol"	"11-carboxy-alpha-tocotrienol"	"m"
"9-carboxy-alpha-tocotrienol"	"9-carboxy-alpha-tocotrienol"	"m"
"7-carboxy-alpha-tocotrienol"	"7-carboxy-alpha-tocotrienol"	"m"
"5-carboxy-alpha-chromanol"	"5-carboxy-alpha-chromanol"	"m"
"3-carboxy-alpha-chromanol"	"3-carboxy-alpha-chromanol"	"m, c"
"11-carboxy-gamma-tocotrienol"	"11-carboxy-gamma-tocotrienol"	"m"
"9-carboxy-gamma-tocotrienol"	"9-carboxy-gamma-tocotrienol"	"m"
"7-carboxy-gamma-tocotrienol"	"7-carboxy-gamma-tocotrienol"	"m"
"5-carboxy-gamma-chromanol"	"5-carboxy-gamma-chromanol"	"m"
"gamma-carboxyethyl-hydroxychroman"	"gamma-carboxyethyl-hydroxychroman"	"m, c"
"11-carboxy-gamma-chromanol"	"11-carboxy-gamma-chromanol"	"m"
"9-carboxy-gamma-chromanol"	"9-carboxy-gamma-chromanol"	"m"
"7-carboxy-gamma-chromanol"	"7-carboxy-gamma-chromanol"	"m"
"11-carboxy-alpha-chromanol"	"11-carboxy-alpha-chromanol"	"m"
"9-carboxy-alpha-chromanol"	"9-carboxy-alpha-chromanol"	"m"
"7-carboxy-alpha-chromanol"	"7-carboxy-alpha-chromanol"	"m"
"gamma-CEHC-glucuronide"	"gamma-CEHC-glucuronide"	"c"
"alpha-CEHC-glucuronide"	"alpha-CEHC-glucuronide"	"c"
"benzo[a]pyrene"	"benzo[a]pyrene"	"c"
"benzo[a]pyrene-9,10-oxide"	"benzo[a]pyrene-9,10-oxide"	"c"
"benzo[a]pyrene-7,8-oxide"	"benzo[a]pyrene-7,8-oxide"	"c"
"benzo[a]pyrene-4,5-oxide"	"benzo[a]pyrene-4,5-oxide"	"c"
"4,5-dihydro-4-hydroxy-5-S-glutathionyl-benzo[a]pyrene"	"4,5-dihydro-4-hydroxy-5-S-glutathionyl-benzo[a]pyrene"	"c"
"benzo[a]pyrene-7,8-diol"	"benzo[a]pyrene-7,8-diol"	"c"
"7,8-dihydro-7-hydroxy-8-S-glutathionyl-benzo[a]pyrene"	"7,8-dihydro-7-hydroxy-8-S-glutathionyl-benzo[a]pyrene"	"c"
"benzo[a]pyrene-7,8-dihydrodiol-9,10-oxide"	"benzo[a]pyrene-7,8-dihydrodiol-9,10-oxide"	"c"
"9-hydroxybenzo[a]pyrene"	"9-hydroxybenzo[a]pyrene"	"c"
"9-hydroxybenzo[a]pyrene-4,5-oxide"	"9-hydroxybenzo[a]pyrene-4,5-oxide"	"c"
"naphthalene"	"naphthalene"	"c"
"(1R,2S)-naphthalene1,2-oxide"	"(1R,2S)-naphthalene1,2-oxide"	"c"
"(1S,2R)-naphthalene1,2-oxide"	"(1S,2R)-naphthalene1,2-oxide"	"c"
"(1R)-hydroxy-(2R)-glutathionyl-1,2-dihydronaphthalene"	"(1R)-hydroxy-(2R)-glutathionyl-1,2-dihydronaphthalene"	"c"
"1,2-dihydronaphthalene-1,2-diol"	"1,2-dihydronaphthalene-1,2-diol"	"c"
"(1S)-hydroxy-(2S)-glutathionyl-1,2-dihydronaphthalene"	"(1S)-hydroxy-(2S)-glutathionyl-1,2-dihydronaphthalene"	"c"
"aflatoxinB1"	"aflatoxinB1"	"c"
"aflatoxinQ1"	"aflatoxinQ1"	"c"
"aflatoxinM1"	"aflatoxinM1"	"c"
"aflatoxinM1-8,9-epoxide"	"aflatoxinM1-8,9-epoxide"	"c"
"aflatoxinB1-exo-8,9-epoxide"	"aflatoxinB1-exo-8,9-epoxide"	"c"
"aflatoxinB1-exo-8,9-epoxide-GSH"	"aflatoxinB1-exo-8,9-epoxide-GSH"	"c"
"aflatoxinB1diol"	"aflatoxinB1diol"	"c"
"trichloroethene"	"trichloroethene"	"c"
"S-(1,2-dichlorovinyl)glutathione"	"S-(1,2-dichlorovinyl)glutathione"	"c"
"hydrochloride"	"hydrochloride"	"c"
"TAGepoxide"	"TAGepoxide"	"c"
"chloral"	"chloral"	"c"
"chloralhydrate"	"chloralhydrate"	"c"
"trichloroacetate"	"trichloroacetate"	"c"
"trichloroethanol"	"trichloroethanol"	"c"
"bromobenzene"	"bromobenzene"	"c"
"bromobenzene-3,4-oxide"	"bromobenzene-3,4-oxide"	"c"
"3,4-dihydro-3-hydroxy-4-S-glutathionylbromobenzene"	"3,4-dihydro-3-hydroxy-4-S-glutathionylbromobenzene"	"c"
"bromobenzene-3,4-dihydrodiol"	"bromobenzene-3,4-dihydrodiol"	"c"
"4-bromophenol"	"4-bromophenol"	"c"
"4-bromophenol-2,3-epoxide"	"4-bromophenol-2,3-epoxide"	"c"
"bromobenzene-2,3-oxide"	"bromobenzene-2,3-oxide"	"c"
"2,3-dihydro-2-S-glutathionyl-3-hydroxybromobenzene"	"2,3-dihydro-2-S-glutathionyl-3-hydroxybromobenzene"	"c"
"bromobenzene-2,3-dihydrodiol"	"bromobenzene-2,3-dihydrodiol"	"c"
"7,12-dimethylbenz[a]anthracene"	"7,12-dimethylbenz[a]anthracene"	"c"
"1a,11b-dihydro-4,9-dimethylbenz[a]anthra[3,4-b]oxirene"	"1a,11b-dihydro-4,9-dimethylbenz[a]anthra[3,4-b]oxirene"	"c"
"7-hydroxymethyl-12-methylbenz[a]anthracene"	"7-hydroxymethyl-12-methylbenz[a]anthracene"	"c"
"7,12-dimethylbenz[a]anthracene5,6-oxide"	"7,12-dimethylbenz[a]anthracene5,6-oxide"	"c"
"trans-3,4-dihydro-3,4-dihydroxy-7,12-dimethylbenz[a]anthracene"	"trans-3,4-dihydro-3,4-dihydroxy-7,12-dimethylbenz[a]anthracene"	"c"
"(1aalpha,2beta,3alpha,11calpha)-1a,2,3,11c-tetrahydro-6,11-dimethylbenzo[6,7]phenanthro[3,4-b]oxirene-2,3-diol"	"(1aalpha,2beta,3alpha,11calpha)-1a,2,3,11c-tetrahydro-6,11-dimethylbenzo[6,7]phenanthro[3,4-b]oxirene-2,3-diol"	"c"
"trans-5,6-dihydro-5,6-dihydroxy-7,12-dimethylbenz[a]anthracene"	"trans-5,6-dihydro-5,6-dihydroxy-7,12-dimethylbenz[a]anthracene"	"c"
"4-(n-nitrosomethylamino)-1-(3-pyridyl)-1-butanone"	"4-(n-nitrosomethylamino)-1-(3-pyridyl)-1-butanone"	"c"
"4-(methylnitrosamino)-1-(3-pyridyl)-1-butanol"	"4-(methylnitrosamino)-1-(3-pyridyl)-1-butanol"	"c"
"4-[(hydroxymethyl)nitrosoamino]-1-(3-pyridinyl)-1-butanone"	"4-[(hydroxymethyl)nitrosoamino]-1-(3-pyridinyl)-1-butanone"	"c"
"4-hydroxy-4-(methylnitrosoamino)-1-(3-pyridinyl)-1-butanone"	"4-hydroxy-4-(methylnitrosoamino)-1-(3-pyridinyl)-1-butanone"	"c"
"1-nitronaphthalene"	"1-nitronaphthalene"	"c"
"1-nitronaphthalene-5,6-oxide"	"1-nitronaphthalene-5,6-oxide"	"c"
"1-nitro-5-hydroxy-6-glutathionyl-5,6-dihydronaphthalene"	"1-nitro-5-hydroxy-6-glutathionyl-5,6-dihydronaphthalene"	"c"
"1-nitro-5-glutathionyl-6-hydroxy-5,6-dihydronaphthalene"	"1-nitro-5-glutathionyl-6-hydroxy-5,6-dihydronaphthalene"	"c"
"1-nitro-5,6-dihydroxy-dihydronaphthalene"	"1-nitro-5,6-dihydroxy-dihydronaphthalene"	"c"
"1-nitronaphthalene-7,8-oxide"	"1-nitronaphthalene-7,8-oxide"	"c"
"1-nitro-7-hydroxy-8-glutathionyl-7,8-dihydronaphthalene"	"1-nitro-7-hydroxy-8-glutathionyl-7,8-dihydronaphthalene"	"c"
"1-nitro-7-glutathionyl-8-hydroxy-7,8-dihydronaphthalene"	"1-nitro-7-glutathionyl-8-hydroxy-7,8-dihydronaphthalene"	"c"
"1,1-dichloroethylene"	"1,1-dichloroethylene"	"c"
"2,2-dichloroacetaldehyde"	"2,2-dichloroacetaldehyde"	"c"
"S-(2,2-dichloro-1-hydroxy)ethylglutathione"	"S-(2,2-dichloro-1-hydroxy)ethylglutathione"	"c"
"1,1-dichloroethyleneepoxide"	"1,1-dichloroethyleneepoxide"	"c"
"2-(S-glutathionyl)acetylchloride"	"2-(S-glutathionyl)acetylchloride"	"c"
"2-(S-glutathionyl)acetylglutathione"	"2-(S-glutathionyl)acetylglutathione"	"c"
"chloroacetylchloride"	"chloroacetylchloride"	"c"
"S-(2-chloroacetyl)glutathione"	"S-(2-chloroacetyl)glutathione"	"c"
"1,2-dibromoethane"	"1,2-dibromoethane"	"c"
"2-bromoacetaldehyde"	"2-bromoacetaldehyde"	"c"
"hydrobromicacid"	"hydrobromicacid"	"c"
"S-(formylmethyl)glutathione"	"S-(formylmethyl)glutathione"	"c"
"PNP"	"PNP"	"c, e"
"4-nitrophenyl-sulfate"	"4-nitrophenyl-sulfate"	"c"
"4-nitrocatechol"	"4-nitrocatechol"	"c"
"hypochlorite"	"hypochlorite"	"c"
"chloride"	"chloride"	"c, e"
"nitrite"	"nitrite"	"c"
"nitryl-chloride"	"nitryl-chloride"	"c"
"4-nitrophenyl-phosphate"	"4-nitrophenyl-phosphate"	"e"
"methanol"	"methanol"	"c, l"
"reducedferredoxin"	"reducedferredoxin"	"m"
"oxidizedferredoxin"	"oxidizedferredoxin"	"m"
"dextrin"	"dextrin"	"c"
"dextrin(n-1)"	"dextrin(n-1)"	"c"
"1-deoxy-1-(N6-lysino)-D-fructose"	"1-deoxy-1-(N6-lysino)-D-fructose"	"c"
"fructoselysine-3-phosphate"	"fructoselysine-3-phosphate"	"c"
"fructoseglycine-ketone-3-phosphate"	"fructoseglycine-ketone-3-phosphate"	"c"
"fructoseglycine"	"fructoseglycine"	"c"
"neurotensin"	"neurotensin"	"c"
"neurotensin1-10"	"neurotensin1-10"	"c"
"neurotensin11-13"	"neurotensin11-13"	"c"
"dynorphinA-(1-8)"	"dynorphinA-(1-8)"	"c"
"dynorphinA-(1-5)"	"dynorphinA-(1-5)"	"c"
"dynorphinA-(6-8)"	"dynorphinA-(6-8)"	"c"
"L-sorbose"	"L-sorbose"	"c"
"L-iditol"	"L-iditol"	"c"
"2,3-cyclic-UMP"	"2,3-cyclic-UMP"	"c"
"3-UMP"	"3-UMP"	"c"
"neuromedinB"	"neuromedinB"	"c"
"neuromedinB(1-3)"	"neuromedinB(1-3)"	"c"
"neuromedinB(4-10)"	"neuromedinB(4-10)"	"c"
"neuromedinN"	"neuromedinN"	"c"
"neuromedinN(1-4)"	"neuromedinN(1-4)"	"c"
"hippurate"	"hippurate"	"c"
"O-methylhippurate"	"O-methylhippurate"	"c"
"TRH"	"TRH"	"c"
"histidyl-prolinamide"	"histidyl-prolinamide"	"c"
"kinetensin"	"kinetensin"	"c"
"kinetensin1-8"	"kinetensin1-8"	"c"
"P1,P4-bis(5-guanosyl)-tetraphosphate"	"P1,P4-bis(5-guanosyl)-tetraphosphate"	"c"
"chitin"	"chitin"	"c"
"chitin(n-1)"	"chitin(n-1)"	"c"
"(ADP-D-ribosyl)n1-acceptor"	"(ADP-D-ribosyl)n1-acceptor"	"c"
"(ADP-D-ribosyl)n-acceptor"	"(ADP-D-ribosyl)n-acceptor"	"c"
"[phosphorylaseB]"	"[phosphorylaseB]"	"c"
"[phosphorylaseA]"	"[phosphorylaseA]"	"c"
"ubiquitinCterminalthiolester"	"ubiquitinCterminalthiolester"	"c"
"thiol"	"thiol"	"c"
"ubiquitin"	"ubiquitin"	"c"
"[protein]-N-ubiquityllysine"	"[protein]-N-ubiquityllysine"	"c"
"peptidylproline-(omega=0)"	"peptidylproline-(omega=0)"	"c"
"peptidylproline-(omega=180)"	"peptidylproline-(omega=180)"	"c"
"[myosinlightchain]"	"[myosinlightchain]"	"c"
"[myosinlightchain]-phosphate"	"[myosinlightchain]-phosphate"	"c"
"histone-N6-acetyl-L-lysine"	"histone-N6-acetyl-L-lysine"	"c"
"[protein]-L-glutamine"	"[protein]-L-glutamine"	"c"
"alkylamine"	"alkylamine"	"c"
"[protein]-N5-alkylglutamine"	"[protein]-N5-alkylglutamine"	"c"
"apppA"	"apppA"	"c"
"DNAcontaining6-O-methylguanine"	"DNAcontaining6-O-methylguanine"	"c"
"DNAcontainingguanine"	"DNAcontainingguanine"	"c"
"[protein]-S-methyl-L-cysteine"	"[protein]-S-methyl-L-cysteine"	"c"
"S-palmitoylprotein"	"S-palmitoylprotein"	"c"
"[protein]-L-isoaspartate-methylester"	"[protein]-L-isoaspartate-methylester"	"c"
"[protein]-L-isoaspartate"	"[protein]-L-isoaspartate"	"c"
"oxytocin"	"oxytocin"	"c"
"glycinamide"	"glycinamide"	"c"
"oxytocin1-8"	"oxytocin1-8"	"c"
"6-methylmercaptopurine"	"6-methylmercaptopurine"	"c"
"thiopurine"	"thiopurine"	"c"
"alphatubulin"	"alphatubulin"	"c"
"detyrosinatedalpha-tubulin"	"detyrosinatedalpha-tubulin"	"c"
"3-phosphopolynucleotide"	"3-phosphopolynucleotide"	"c"
"polynucleotide"	"polynucleotide"	"c"
"5-phosphopolynucleotide"	"5-phosphopolynucleotide"	"c"
"(5)ppPur-mRNA"	"(5)ppPur-mRNA"	"c"
"G(5)pppR-RNA"	"G(5)pppR-RNA"	"c"
"m7G(5')pppR-RNA"	"m7G(5')pppR-RNA"	"c"
"m7G(5')pppm6Am(mRNAcontaininganN6,2'-O-dimethyladenosinecap)"	"m7G(5')pppm6Am(mRNAcontaininganN6,2'-O-dimethyladenosinecap)"	"c"
"m7G(5')pppAm"	"m7G(5')pppAm"	"c"
"N-tetradecanoylglycylpeptide"	"N-tetradecanoylglycylpeptide"	"c"
"glycylpeptide"	"glycylpeptide"	"c"
"NG,NG-dimethyl-L-arginine"	"NG,NG-dimethyl-L-arginine"	"c"
"dimethylamine"	"dimethylamine"	"c"
"trimethylamine"	"trimethylamine"	"c"
"trimethylamine-N-oxide"	"trimethylamine-N-oxide"	"c"
"N-acetyl-O-acetylneuraminate"	"N-acetyl-O-acetylneuraminate"	"c"
"[pyruvatedehydrogenase(acetyltransferring)]-phosphate"	"[pyruvatedehydrogenase(acetyltransferring)]-phosphate"	"c"
"[pyruvatedehydrogenase(acetyltransferring)]"	"[pyruvatedehydrogenase(acetyltransferring)]"	"c"
"tRNA-queuine"	"tRNA-queuine"	"c"
"queuine"	"queuine"	"c"
"tRNA-guanine"	"tRNA-guanine"	"c"
"tRNAcontainingN2-methylguanine"	"tRNAcontainingN2-methylguanine"	"c"
"tRNAcontainingN7-methylguanine"	"tRNAcontainingN7-methylguanine"	"c"
"tRNAcontaining5-methylaminomethyl-2-thiouridylate"	"tRNAcontaining5-methylaminomethyl-2-thiouridylate"	"c"
"tRNAcontaining5-aminomethyl-2-thiouridine"	"tRNAcontaining5-aminomethyl-2-thiouridine"	"c"
"N-substitutedaminoacyltRNA"	"N-substitutedaminoacyltRNA"	"c"
"N-substitutedaminoacid"	"N-substitutedaminoacid"	"c"
"tRNA"	"tRNA"	"c"
"tRNAcontaining6-isopentenyladenosine"	"tRNAcontaining6-isopentenyladenosine"	"c"
"tRNA-pseudouridine"	"tRNA-pseudouridine"	"c"
"tRNA-uridine"	"tRNA-uridine"	"c"
"arsenite"	"arsenite"	"c"
"methylarsonate"	"methylarsonate"	"c"
"acetanilide"	"acetanilide"	"c"
"aniline"	"aniline"	"c"
"[beta-adrenergic-receptor]"	"[beta-adrenergic-receptor]"	"c"
"phospho-[betaadrenergicreceptor]"	"phospho-[betaadrenergicreceptor]"	"c"
"N4-(acetyl-beta-D-glucosaminyl)asparagine"	"N4-(acetyl-beta-D-glucosaminyl)asparagine"	"c"
"N-acetyl-beta-D-glucosaminylamine"	"N-acetyl-beta-D-glucosaminylamine"	"c"
"4-N-(n-acetyl-D-glucosaminyl)-protein"	"4-N-(n-acetyl-D-glucosaminyl)-protein"	"c"
"peptide-L-aspartate"	"peptide-L-aspartate"	"c"
"peptide-3-hydroxy-L-aspartate"	"peptide-3-hydroxy-L-aspartate"	"c"
"3-methyl-2-oxobutanoate-dehydrogenase-phosphate"	"3-methyl-2-oxobutanoate-dehydrogenase-phosphate"	"c"
"3-methyl-2-oxobutanoate-dehydrogenase"	"3-methyl-2-oxobutanoate-dehydrogenase"	"c"
"sn-glycero-3-phospho-1-inositol"	"sn-glycero-3-phospho-1-inositol"	"c"
"vitaminK"	"vitaminK"	"c"
"reducedvitaminK"	"reducedvitaminK"	"c"
"oxidizeddithiothreitol"	"oxidizeddithiothreitol"	"c"
"dithiothreitol"	"dithiothreitol"	"c"
"vitaminKepoxide"	"vitaminKepoxide"	"c"
"L-arginyl-protein"	"L-arginyl-protein"	"c"
"[protein]"	"[protein]"	"c, n, r, g, l"
"peptidylamidoglycolate"	"peptidylamidoglycolate"	"c"
"peptidylglycine"	"peptidylglycine"	"c"
"L-glutaminyl-peptide"	"L-glutaminyl-peptide"	"c"
"5-oxoprolyl-peptide"	"5-oxoprolyl-peptide"	"c"
"peptide-L-methionine"	"peptide-L-methionine"	"c"
"peptide-L-methionine-(S)-S-oxide"	"peptide-L-methionine-(S)-S-oxide"	"c"
"peptidyl-L-lysyl-peptide"	"peptidyl-L-lysyl-peptide"	"c"
"peptidyl-allysyl-peptide"	"peptidyl-allysyl-peptide"	"c"
"RNA-terminal-2,3-cyclic-phosphate"	"RNA-terminal-2,3-cyclic-phosphate"	"c"
"RNA-3-terminal-phosphate"	"RNA-3-terminal-phosphate"	"c"
"lysosomal-enzyme-D-mannose"	"lysosomal-enzyme-D-mannose"	"c"
"lysosomal-enzyme-N-acetyl-D-glucosaminyl-phospho-D-mannose"	"lysosomal-enzyme-N-acetyl-D-glucosaminyl-phospho-D-mannose"	"c"
"glycoprotein-N-acetyl-D-glucosaminyl-phospho-D-mannose"	"glycoprotein-N-acetyl-D-glucosaminyl-phospho-D-mannose"	"c"
"glycoprotein-phospho-D-mannose"	"glycoprotein-phospho-D-mannose"	"c"
"peptide-2-[3-carboxy-3-(methylammonio)propyl]-L-histidine"	"peptide-2-[3-carboxy-3-(methylammonio)propyl]-L-histidine"	"c"
"peptide-2-(3-carboxy-3-aminopropyl)-L-histidine"	"peptide-2-(3-carboxy-3-aminopropyl)-L-histidine"	"c"
"[methioninesynthase]-cob(II)alamin"	"[methioninesynthase]-cob(II)alamin"	"c"
"[methioninesynthase]-methylcob(I)alamin"	"[methioninesynthase]-methylcob(I)alamin"	"c"
"formyl-L-methionyl-peptide"	"formyl-L-methionyl-peptide"	"c"
"methionyl-peptide"	"methionyl-peptide"	"c"
"diphospho-myo-inositol-polyphosphate"	"diphospho-myo-inositol-polyphosphate"	"c"
"myo-inositol-polyphosphate"	"myo-inositol-polyphosphate"	"c"
"procollagen-L-lysine"	"procollagen-L-lysine"	"c"
"L-hydroxylysine"	"L-hydroxylysine"	"c"
"3-(acyloxy)acylgroupofbacterialtoxin"	"3-(acyloxy)acylgroupofbacterialtoxin"	"c"
"3-hydroxyacylgroupofbacterialtoxin"	"3-hydroxyacylgroupofbacterialtoxin"	"c"
"lactose-6-phosphate"	"lactose-6-phosphate"	"e"
"N-acetyl-L-glutamate-5-phosphate"	"N-acetyl-L-glutamate-5-phosphate"	"m"
"N-acetyl-L-glutamate5-semialdehyde"	"N-acetyl-L-glutamate5-semialdehyde"	"m"
"2-phosphoglycolate"	"2-phosphoglycolate"	"c"
"N-trimethyl-2-aminoethylphosphonate"	"N-trimethyl-2-aminoethylphosphonate"	"c"
"CMP-N-trimethyl-2-aminoethylphosphonate"	"CMP-N-trimethyl-2-aminoethylphosphonate"	"c"
"2-aminoethylphosphonate"	"2-aminoethylphosphonate"	"c"
"CMP-2-aminoethylphosphonate"	"CMP-2-aminoethylphosphonate"	"c"
"N-methylputrescine"	"N-methylputrescine"	"c"
"1-methylpyrrolinium"	"1-methylpyrrolinium"	"c"
"perillylaldehyde"	"perillylaldehyde"	"c, m"
"perillicacid"	"perillicacid"	"c, m"
"trans-2-methyl-5-isopropylhexa-2,5-dienoyl-CoA"	"trans-2-methyl-5-isopropylhexa-2,5-dienoyl-CoA"	"m, p"
"3-hydroxy-2,6-dimethyl-5-methylene-heptanoyl-CoA"	"3-hydroxy-2,6-dimethyl-5-methylene-heptanoyl-CoA"	"m, p"
"cis-2-methyl-5-isopropylhexa-2,5-dienoyl-CoA"	"cis-2-methyl-5-isopropylhexa-2,5-dienoyl-CoA"	"m, p"
"P1,P4-bis(5-adenosyl)-tetraphosphate"	"P1,P4-bis(5-adenosyl)-tetraphosphate"	"c"
"gamma-glutamyl-beta-cyanoalanine"	"gamma-glutamyl-beta-cyanoalanine"	"e"
"L-3-cyanoalanine"	"L-3-cyanoalanine"	"e"
"gamma-glutamyl-3-aminopropiononitrile"	"gamma-glutamyl-3-aminopropiononitrile"	"e"
"5-methyltetrahydropteroyltri-L-glutamate"	"5-methyltetrahydropteroyltri-L-glutamate"	"c"
"tetrahydropteroyltri-L-glutamate"	"tetrahydropteroyltri-L-glutamate"	"c"
"phosphoprotein"	"phosphoprotein"	"c"
"protamine"	"protamine"	"c"
"O-phosphoprotamine"	"O-phosphoprotamine"	"c"
"guanidine"	"guanidine"	"c, e"
"metformin"	"metformin"	"e, c"
"quinidine"	"quinidine"	"e, c"
"Mg2"	"Mg2"	"e, c"
"Cu2"	"Cu2"	"e, c"
"cimetidine"	"cimetidine"	"e, c"
"insulin-(SS)"	"insulin-(SS)"	"c"
"Insulin-(SH)2"	"Insulin-(SH)2"	"c"
"1-acylglycerol-VLDLpool"	"1-acylglycerol-VLDLpool"	"c, e"
"HDL"	"HDL"	"e"
"HDLremnant"	"HDLremnant"	"e"
"LDL"	"LDL"	"e"
"LDLremnant"	"LDLremnant"	"e"
"VLDL"	"VLDL"	"e"
"TAG-VLDLpool"	"TAG-VLDLpool"	"e"
"VLDLremnant"	"VLDLremnant"	"e, l"
"1,2-diacylglycerol-VLDLpool"	"1,2-diacylglycerol-VLDLpool"	"e"
"fattyacid-VLDLpool"	"fattyacid-VLDLpool"	"e"
"K"	"K"	"c, e, g"
"taurolithocholate"	"taurolithocholate"	"e, c"
"glycolithocholate"	"glycolithocholate"	"e, c"
"tauroursodeoxycholate"	"tauroursodeoxycholate"	"e, c"
"glycoursodeoxycholate"	"glycoursodeoxycholate"	"e, c"
"sulfochenodeoxycholate"	"sulfochenodeoxycholate"	"e, c"
"homoserine"	"homoserine"	"e, c"
"zinc"	"zinc"	"e, c, g, r"
"estrone3-sulfate"	"estrone3-sulfate"	"e, c"
"dehydroepiandrosteronesulfate"	"dehydroepiandrosteronesulfate"	"e, c"
"sulfotaurolithocholate"	"sulfotaurolithocholate"	"c, e"
"Ca2"	"Ca2"	"c, e"
"estradiol-17beta3-glucuronide"	"estradiol-17beta3-glucuronide"	"c, e, r"
"androsterone-glucuronide"	"androsterone-glucuronide"	"c, e"
"etiocholan-3alpha-ol-17-one3-glucuronide"	"etiocholan-3alpha-ol-17-one3-glucuronide"	"c, e"
"16-glucuronide-estriol"	"16-glucuronide-estriol"	"c, e"
"5alpha-dihydrotestosterone-glucuronide"	"5alpha-dihydrotestosterone-glucuronide"	"c, e"
"cytosine"	"cytosine"	"c, e"
"D-serine"	"D-serine"	"c, e"
"testosteroneglucuronide"	"testosteroneglucuronide"	"c, e"
"D-xylose"	"D-xylose"	"c, e"
"D-proline"	"D-proline"	"e, c, l"
"creatinine"	"creatinine"	"e, c"
"Li"	"Li"	"e"
